acheter	to buy	[sound:acheter.mp3]	Commonly-Used
advenir	to happen	[sound:advenir.mp3]	Commonly-Used
aider	to help, assist	[sound:aider.mp3]	Commonly-Used
aimer	to like, to love	[sound:aimer.mp3]	Commonly-Used
ajouter	to add	[sound:ajouter.mp3]	Commonly-Used
appeler	to call, name, appeal	[sound:appeler.mp3]	Commonly-Used
apporter	to bring, bear	[sound:apporter.mp3]	Commonly-Used
apprendre	to learn	[sound:apprendre.mp3]	Commonly-Used
arrêter	to stop, arrest	[sound:arr%C3%AAter.mp3]	Commonly-Used
attendre	to wait, wait for, expect	[sound:attendre.mp3]	Commonly-Used
connaître	to know, be acquainted	[sound:conna%C3%AEtre.mp3]	Commonly-Used
continuer	to continue	[sound:continuer.mp3]	Commonly-Used
contrôler	to check, inspect, test, supervise, control	[sound:contr%C3%B4ler.mp3]	Commonly-Used
corriger	to correct	[sound:corriger.mp3]	Commonly-Used
coucher	to put to bed, lay, flatten	[sound:coucher.mp3]	Commonly-Used
couper	to cut, switch off	[sound:couper.mp3]	Commonly-Used
courir	to run, race	[sound:courir.mp3]	Commonly-Used
coûter	to cost	[sound:co%C3%BBter.mp3]	Commonly-Used
croire	to believe	[sound:croire.mp3]	Commonly-Used
cuire	to cook	[sound:cuire.mp3]	Commonly-Used
décider	to decide	[sound:d%C3%A9cider.mp3]	Commonly-Used
décrire	to describe	[sound:d%C3%A9crire.mp3]	Commonly-Used
demander	to ask for	[sound:demander.mp3]	Commonly-Used
enlever	to carry away, take away, remove	[sound:enlever.mp3]	Commonly-Used
enseigner	to teach	[sound:enseigner.mp3]	Commonly-Used
entendre	to hear, understand	[sound:entendre.mp3]	Commonly-Used
envoyer	to send	[sound:envoyer.mp3]	Commonly-Used
espérer	to hope	[sound:esp%C3%A9rer.mp3]	Commonly-Used
essayer	to try	[sound:essayer.mp3]	Commonly-Used
étudier	to study	[sound:%C3%A9tudier.mp3]	Commonly-Used
inviter	to invite	[sound:inviter.mp3]	Commonly-Used
jouer	to play, act (in a play), gamble	[sound:jouer.mp3]	Commonly-Used
laver	to wash	[sound:laver.mp3]	Commonly-Used
lever	to lift, raise	[sound:lever.mp3]	Commonly-Used
lire	to read	[sound:lire.mp3]	Commonly-Used
manger	to eat	[sound:manger.mp3]	Commonly-Used
mettre	to put (set), put on, place<br /><br />*many different meanings, and very common with expressions	[sound:mettre.mp3]	Commonly-Used
nager	to swim	[sound:nager.mp3]	Commonly-Used
pleurer	to cry, weep, mourn	[sound:pleurer.mp3]	Commonly-Used
pleuvoir	to rain	[sound:pleuvoir.mp3]	Commonly-Used
porter	to wear, to carry	[sound:porter.mp3]	Commonly-Used
préférer	to prefer	[sound:pr%C3%A9f%C3%A9rer.mp3]	Commonly-Used
prendre	to take (as in grab, bring, take notes,etc).<br /><br />*many uses, very common in expressions	[sound:prendre.mp3]	Commonly-Used
se promener	to take a walk	[sound:se+promener.mp3]	Commonly-Used
promettre	promise	[sound:promettre.mp3]	Commonly-Used
proposer	to propose, suggest	[sound:proposer.mp3]	Commonly-Used
provenir	to be from, be the result of, be due to	[sound:provenir.mp3]	Commonly-Used
quitter	to leave, quit, split up	[sound:quitter.mp3]	Commonly-Used
raconter	to tell, recount	[sound:raconter.mp3]	Commonly-Used
recevoir	to receive, get	[sound:recevoir.mp3]	Commonly-Used
reconnaître	to recognize, acknowledge	[sound:reconna%C3%AEtre.mp3]	Commonly-Used
savoir	to know (how)	[sound:savoir.mp3]	Commonly-Used
sentir	to feel, smell, perceive	[sound:sentir.mp3]	Commonly-Used
souhaiter	to wish	[sound:souhaiter.mp3]	Commonly-Used
suivre	to follow	[sound:suivre.mp3]	Commonly-Used
susciter	to arouse, give rise to	[sound:susciter.mp3]	Commonly-Used
tenir	to hold, grasp	[sound:tenir.mp3]	Commonly-Used
terminer	to terminate, finish, end	[sound:terminer.mp3]	Commonly-Used
avoir besoin	to need	[sound:avoir+besoin.mp3]	Commonly-Used
blesser	to hurt, injure, wound, offend	[sound:blesser.mp3]	Commonly-Used
boire	to drink	[sound:boire.mp3]	Commonly-Used
brûler	to burn	[sound:br%C3%BBler.mp3]	Commonly-Used
cacher	to hide	[sound:cacher.mp3]	Commonly-Used
changer	to change	[sound:changer.mp3]	Commonly-Used
choisir	to choose, select, pick	[sound:choisir.mp3]	Commonly-Used
commencer	to begin, start, commence	[sound:commencer.mp3]	Commonly-Used
compléter	to make up, complete, complement, add to	[sound:compl%C3%A9ter.mp3]	Commonly-Used
comprendre	to understand<br>to include	[sound:comprendre.mp3]	Commonly-Used
dépêcher	to dispatch	[sound:d%C3%A9p%C3%AAcher.mp3]	Commonly-Used
détester	to detest, dislike, hate	[sound:d%C3%A9tester.mp3]	Commonly-Used
dire	to say, tell	[sound:dire.mp3]	Commonly-Used
donner 	to give	[sound:donner+.mp3]	Commonly-Used
dormir	to sleep	[sound:dormir.mp3]	Commonly-Used
douter	to doubt	[sound:douter.mp3]	Commonly-Used
écouter	to listen	[sound:%C3%A9couter.mp3]	Commonly-Used
écrire	to write	[sound:%C3%A9crire.mp3]	Commonly-Used
effacer	to erase, rub out, delete	[sound:effacer.mp3]	Commonly-Used
élever	to raise, rear, bring up	[sound:%C3%A9lever.mp3]	Commonly-Used
fermer	to close	[sound:fermer.mp3]	Commonly-Used
finir	to finish, end, terminate, complete	[sound:finir.mp3]	Commonly-Used
forcer	to force	[sound:forcer.mp3]	Commonly-Used
fumer	to smoke, steam	[sound:fumer.mp3]	Commonly-Used
gagner	to win, earn, gain	[sound:gagner.mp3]	Commonly-Used
garder	to guard, keep, retain	[sound:garder.mp3]	Commonly-Used
goûter	to taste, have a snack, enjoy	[sound:go%C3%BBter.mp3]	Commonly-Used
haïr	to hate	[sound:ha%C3%AFr.mp3]	Commonly-Used
inclure	to include, enclose	[sound:inclure.mp3]	Commonly-Used
s'inquiéter	to worry, to be upset	[sound:s%27inqui%C3%A9ter.mp3]	Commonly-Used
neiger	to snow	[sound:neiger.mp3]	Commonly-Used
nettoyer	to clean	[sound:nettoyer.mp3]	Commonly-Used
noter	to write down<br>to notice<br>to mark, grade, assess	[sound:noter.mp3]	Commonly-Used
obéir	to obey	[sound:ob%C3%A9ir.mp3]	Commonly-Used
obtenir	to obtain, to get	[sound:obtenir.mp3]	Commonly-Used
occuper	to occupy	[sound:occuper.mp3]	Commonly-Used
offrir	to offer	[sound:offrir.mp3]	Commonly-Used
oublier	to forget	[sound:oublier.mp3]	Commonly-Used
ouvrir	to open	[sound:ouvrir.mp3]	Commonly-Used
pardonner	to pardon, forgive	[sound:pardonner.mp3]	Commonly-Used
parler	to talk	[sound:parler.mp3]	Commonly-Used
payer	to pay	[sound:payer.mp3]	Commonly-Used
penser	to think	[sound:penser.mp3]	Commonly-Used
perdre	to lose (something, location, etc)	[sound:perdre.mp3]	Commonly-Used
placer 	to place, put	[sound:placer+.mp3]	Commonly-Used
refaire	to redo	[sound:refaire.mp3]	Commonly-Used
réfléchir	to think, meditate, reflect, ponder	[sound:r%C3%A9fl%C3%A9chir.mp3]	Commonly-Used
refuser	to refuse, withhold	[sound:refuser.mp3]	Commonly-Used
regarder	to look at, watch	[sound:regarder.mp3]	Commonly-Used
regretter	to regret, miss	[sound:regretter.mp3]	Commonly-Used
remercier	to thank	[sound:remercier.mp3]	Commonly-Used
remplacer	to replace	[sound:remplacer.mp3]	Commonly-Used
remplir	to fill	[sound:remplir.mp3]	Commonly-Used
répéter	to repeat. rehearse	[sound:r%C3%A9p%C3%A9ter.mp3]	Commonly-Used
répondre	to respond, reply, answer	[sound:r%C3%A9pondre.mp3]	Commonly-Used
réussir	to succeed, result	[sound:r%C3%A9ussir.mp3]	Commonly-Used
se réveiller	to wake up	[sound:se+r%C3%A9veiller.mp3]	Commonly-Used
révéler	to reveal, discover, bring to fame	[sound:r%C3%A9v%C3%A9ler.mp3]	Commonly-Used
aller	to go	[sound:aller.mp3]	Être-Verbs
arriver	to arrive<br />to happen	[sound:arriver.mp3]	Être-Verbs
entrer	to enter, come in, go in	[sound:entrer.mp3]	Être-Verbs
monter	to go up, climb, take up, bring up, mount	[sound:monter.mp3]	Être-Verbs
naître	to be born	[sound:na%C3%AEtre.mp3]	Être-Verbs
mourir	to die	[sound:mourir.mp3]	Être-Verbs
sortir	to go out, leave	[sound:sortir.mp3]	Être-Verbs
tomber	to fall	[sound:tomber.mp3]	Être-Verbs
descendre	to descend go down, take down, bring down	[sound:descendre.mp3]	Être-Verbs
devenir	to become	[sound:devenir.mp3]	Être-Verbs
partir	to leave, go away	[sound:partir.mp3]	Être-Verbs
parvenir	to reach, send, achieve	[sound:parvenir.mp3]	Être-Verbs
passer	to go, take, pass, spend time<br /><br />*numerous uses, common in expressions	[sound:passer.mp3]	Être-Verbs
rentrer	to return (to a place)	[sound:rentrer.mp3]	Être-Verbs
rester	to remain, stay, be left (over)	[sound:rester.mp3]	Être-Verbs
retourner	to return	[sound:retourner.mp3]	Être-Verbs
revenir	to come back	[sound:revenir.mp3]	Être-Verbs
venir	to come	[sound:venir.mp3]	Être-Verbs
avoir	to have	[sound:avoir.mp3]	Core-Verbs
être	to be	[sound:%C3%AAtre.mp3]	Core-Verbs
faire	to make, do	[sound:faire.mp3]	Core-Verbs
pouvoir	to be able, can	[sound:pouvoir.mp3]	Modal-Verbs
devoir	to have to, must, ought, owe, should	[sound:devoir.mp3]	Modal-Verbs
vouloir	to want	[sound:vouloir.mp3]	Modal-Verbs
abaisser	to lower, reduce, humilitate, humble	[sound:abaisser.mp3]	Standard-Verbs
abasourdir	to daze, deafen, stun, bewilder, stupefy	[sound:abasourdir.mp3]	Standard-Verbs
abattre	to knock, pull, cut, shoot, or bring down, slaughter<br />to dishearten	[sound:abattre.mp3]	Standard-Verbs
abolir	to abolish, do away with	[sound:abolir.mp3]	Standard-Verbs
absoudre	to absolve	[sound:absoudre.mp3]	Standard-Verbs
s'abstenir	to abstain	[sound:s%27abstenir.mp3]	Standard-Verbs
accepter	to accept	[sound:accepter.mp3]	Standard-Verbs
acclamer	to acclaim, cheer, applaud	[sound:acclamer.mp3]	Standard-Verbs
accompagner	to accompany	[sound:accompagner.mp3]	Standard-Verbs
accorder	to accord, grant, reconcile, admit	[sound:accorder.mp3]	Standard-Verbs
accourir	to run to, run up to	[sound:accourir.mp3]	Standard-Verbs
accrocher	to hang (up)	[sound:accrocher.mp3]	Standard-Verbs
accueillir	to welcome	[sound:accueillir.mp3]	Standard-Verbs
accuser	to accuse, acknowledge	[sound:accuser.mp3]	Standard-Verbs
achever	to achieve, complete, finish, end	[sound:achever.mp3]	Standard-Verbs
acquérir	to acquire	[sound:acqu%C3%A9rir.mp3]	Standard-Verbs
adjoindre	to appoint (as on a team, position, etc.)	[sound:adjoindre.mp3]	Standard-Verbs
admettre	to admit, pass, suppose	[sound:admettre.mp3]	Standard-Verbs
admirer	to admire	[sound:admirer.mp3]	Standard-Verbs
adorer	to adore, worship	[sound:adorer.mp3]	Standard-Verbs
adresser	to address, send	[sound:adresser.mp3]	Standard-Verbs
affaiblir	to weaken	[sound:affaiblir.mp3]	Standard-Verbs
agacer	to annoy, irritate, pester, vex	[sound:agacer.mp3]	Standard-Verbs
agir	to act/behave, take effect	[sound:agir.mp3]	Standard-Verbs
aménager	to fit out, lay out, develop, plan, adjust	[sound:am%C3%A9nager.mp3]	Standard-Verbs
amener	to bring<br />to lead<br /> <br />*<b>amener</b> is generally used with people, <b>apporter</b> with things.	[sound:amener.mp3]	Standard-Verbs
amuser	to amuse, entertain	[sound:amuser.mp3]	Standard-Verbs
animer	to host, present, lead, bring to life, drive, sustain	[sound:animer.mp3]	Standard-Verbs
annoncer	to announce	[sound:annoncer.mp3]	Standard-Verbs
apercevoir	to perceive	[sound:apercevoir.mp3]	Standard-Verbs
apparaître	to appear	[sound:appara%C3%AEtre.mp3]	Standard-Verbs
appartenir	to belong, pertain	[sound:appartenir.mp3]	Standard-Verbs
mémoriser	to memorize	[sound:m%C3%A9moriser.mp3]	Standard-Verbs
approcher	to approach, to come near, to bring near	[sound:approcher.mp3]	Standard-Verbs
approuver	to approve (of)	[sound:approuver.mp3]	Standard-Verbs
armer	to arm	[sound:armer.mp3]	Standard-Verbs
arracher	to pull up/out, uproot	[sound:arracher.mp3]	Standard-Verbs
arraisonner	to board	[sound:arraisonner.mp3]	Standard-Verbs
arranger	to arrange	[sound:arranger.mp3]	Standard-Verbs
assaillir	to assail, attack, beset	[sound:assaillir.mp3]	Standard-Verbs
s'asseoir	to sit down	[sound:s%27asseoir.mp3]	Standard-Verbs
assister	to attend<br>to assist (at)<br>to be present (at)	[sound:assister.mp3]	Standard-Verbs
assurer	to assure, ensure, insure, guarantee	[sound:assurer.mp3]	Standard-Verbs
astreindre	to compel, oblige	[sound:astreindre.mp3]	Standard-Verbs
attaquer	to attack, contest, tackle, launch, start work on	[sound:attaquer.mp3]	Standard-Verbs
atteindre	to attain	[sound:atteindre.mp3]	Standard-Verbs
attirer	to attract, allure	[sound:attirer.mp3]	Standard-Verbs
attraper	to catch	[sound:attraper.mp3]	Standard-Verbs
augmenter	to augment, increase	[sound:augmenter.mp3]	Standard-Verbs
avancer	to advance, go forward	[sound:avancer.mp3]	Standard-Verbs
avoir raison	to be right	[sound:avoir+raison.mp3]	Standard-Verbs
baisser	to lower, sink	[sound:baisser.mp3]	Standard-Verbs
balancer	to sway, balance, swing<br />to weigh<br />to throw away	[sound:balancer.mp3]	Standard-Verbs
balayer	to sweep	[sound:balayer.mp3]	Standard-Verbs
bâtir	to build	[sound:b%C3%A2tir.mp3]	Standard-Verbs
battre	to beat	[sound:battre.mp3]	Standard-Verbs
bavarder	to chat	[sound:bavarder.mp3]	Standard-Verbs
bêler	to whine (like a sheep)	[sound:b%C3%AAler.mp3]	Standard-Verbs
bénir	to bless	[sound:b%C3%A9nir.mp3]	Standard-Verbs
blaguer	to joke	[sound:blaguer.mp3]	Standard-Verbs
blâmer	to blame	[sound:bl%C3%A2mer.mp3]	Standard-Verbs
blanchir	to whiten, launder, exonerate	[sound:blanchir.mp3]	Standard-Verbs
bouger	to budge, move	[sound:bouger.mp3]	Standard-Verbs
bouillir	to boil	[sound:bouillir.mp3]	Standard-Verbs
briser	to break, ruin (career, life), put an end to	[sound:briser.mp3]	Standard-Verbs
brosser	to brush	[sound:brosser.mp3]	Standard-Verbs
broyer	to grind	[sound:broyer.mp3]	Standard-Verbs
casser	to break, crack, quash	[sound:casser.mp3]	Standard-Verbs
causer	to chat, cause	[sound:causer.mp3]	Standard-Verbs
céder	to yield, cede, give up	[sound:c%C3%A9der.mp3]	Standard-Verbs
ceindre	to put on	[sound:ceindre.mp3]	Standard-Verbs
célébrer	to celebrate	[sound:c%C3%A9l%C3%A9brer.mp3]	Standard-Verbs
cesser	to cease	[sound:cesser.mp3]	Standard-Verbs
chanter	to sing	[sound:chanter.mp3]	Standard-Verbs
charger	to burden, charge, load	[sound:charger.mp3]	Standard-Verbs
chasser	to hunt, chase, drive out	[sound:chasser.mp3]	Standard-Verbs
cheminer	to walk along, follow its course	[sound:cheminer.mp3]	Standard-Verbs
chercher	to look for	[sound:chercher.mp3]	Standard-Verbs
chérir	to cherish	[sound:ch%C3%A9rir.mp3]	Standard-Verbs
chuchoter	to whisper	[sound:chuchoter.mp3]	Standard-Verbs
circoncire	to circumcise	[sound:circoncire.mp3]	Standard-Verbs
circonscrire	to contain	[sound:circonscrire.mp3]	Standard-Verbs
circonvenir	to circumvent<br>to get around	[sound:circonvenir.mp3]	Standard-Verbs
clore	to close, end 	[sound:clore.mp3]	Standard-Verbs
coller	to stick, paste, put	[sound:coller.mp3]	Standard-Verbs
combattre	to combat, fight	[sound:combattre.mp3]	Standard-Verbs
commander	to command, order	[sound:commander.mp3]	Standard-Verbs
commettre	to commit	[sound:commettre.mp3]	Standard-Verbs
comparaître	to appear in court 	[sound:compara%C3%AEtre.mp3]	Standard-Verbs
comparer	to compare	[sound:comparer.mp3]	Standard-Verbs
élire	to elect, choose	[sound:%C3%A9lire.mp3]	Standard-Verbs
s'éloigner	to move away, go away, withdraw, step back, keep back, keep away	[sound:s%27%C3%A9loigner.mp3]	Standard-Verbs
embrasser	to kiss, embrace	[sound:embrasser.mp3]	Standard-Verbs
emmener	to lead, lead away, take away (persons)	[sound:emmener.mp3]	Standard-Verbs
empêcher	to hinder, prevent	[sound:emp%C3%AAcher.mp3]	Standard-Verbs
employer	to employ, use	[sound:employer.mp3]	Standard-Verbs
emprunter	to borrow (from)	[sound:emprunter.mp3]	Standard-Verbs
encourager	to encourage	[sound:encourager.mp3]	Standard-Verbs
endormir	to fall asleep	[sound:endormir.mp3]	Standard-Verbs
enfreindre	to infringe	[sound:enfreindre.mp3]	Standard-Verbs
s'enfuir	to run away, slip away, escape, flee, fly away	[sound:s%27enfuir.mp3]	Standard-Verbs
engager	to commit, bind	[sound:engager.mp3]	Standard-Verbs
enjoindre	to enjoin, forbid, prohibit, command	[sound:enjoindre.mp3]	Standard-Verbs
ennuyer	to bore, annoy, weary<br><br>s'ennuyer = to be bored	[sound:ennuyer.mp3]	Standard-Verbs
énoncer	to express, state	[sound:%C3%A9noncer.mp3]	Standard-Verbs
s'enquérir	to inquire	[sound:s%27enqu%C3%A9rir.mp3]	Standard-Verbs
enregistrer	to record, register, enter, show	[sound:enregistrer.mp3]	Standard-Verbs
enterrer	to bury	[sound:enterrer.mp3]	Standard-Verbs
entraîner	to train, bring about, lead	[sound:entra%C3%AEner.mp3]	Standard-Verbs
entreprendre	to undertake, engage upon	[sound:entreprendre.mp3]	Standard-Verbs
entretenir	to look after	[sound:entretenir.mp3]	Standard-Verbs
entrouvrir	to half-open	[sound:entrouvrir.mp3]	Standard-Verbs
s'envoler	to take flight, take off	[sound:s%27envoler.mp3]	Standard-Verbs
épeler	to spell	[sound:%C3%A9peler.mp3]	Standard-Verbs
épouser	to marry	[sound:%C3%A9pouser.mp3]	Standard-Verbs
éprouver	to try, test, put to the test, feel, experience	[sound:%C3%A9prouver.mp3]	Standard-Verbs
équivaloir	to be equivalent to	[sound:%C3%A9quivaloir.mp3]	Standard-Verbs
essuyer	to wipe, dust, wipe up	[sound:essuyer.mp3]	Standard-Verbs
estimer	to estimate	[sound:estimer.mp3]	Standard-Verbs
établir	to establish, set up, draw up	[sound:%C3%A9tablir.mp3]	Standard-Verbs
éteindre	to extinguish, shut down (computer), turn off	[sound:%C3%A9teindre.mp3]	Standard-Verbs
étonner	to amaze, astonish, stun, surprise	[sound:%C3%A9tonner.mp3]	Standard-Verbs
étourdir	to stun, daze, make dizzy, deafen, bewilder	[sound:%C3%A9tourdir.mp3]	Standard-Verbs
étreindre	to embrace, grip	[sound:%C3%A9treindre.mp3]	Standard-Verbs
évaluer	to evaluate, appraise, assess, estimate	[sound:%C3%A9valuer.mp3]	Standard-Verbs
éviter	to avoid	[sound:%C3%A9viter.mp3]	Standard-Verbs
exagérer	to exaggerate	[sound:exag%C3%A9rer.mp3]	Standard-Verbs
exclure	to expel, suspend, exclude, dismiss	[sound:exclure.mp3]	Standard-Verbs
excuser	to excuse	[sound:excuser.mp3]	Standard-Verbs
exiger	to demand, require	[sound:exiger.mp3]	Standard-Verbs
exister	to exist	[sound:exister.mp3]	Standard-Verbs
expliquer	to explain	[sound:expliquer.mp3]	Standard-Verbs
explorer	to explore	[sound:explorer.mp3]	Standard-Verbs
exprimer	to express	[sound:exprimer.mp3]	Standard-Verbs
faiblir	to get weaker, fail, get fainter, die down, drop, diminish	[sound:faiblir.mp3]	Standard-Verbs
faillir	to fail<br>to almost (do something)	[sound:faillir.mp3]	Standard-Verbs
falloir	to be necessary<br><br>*MANY various uses, common with expressions	[sound:falloir.mp3]	Standard-Verbs
feindre	to feign, make believe, pretend, simulate	[sound:feindre.mp3]	Standard-Verbs
féliciter	to congratulate	[sound:f%C3%A9liciter.mp3]	Standard-Verbs
fendre	to split, crack, cleave	[sound:fendre.mp3]	Standard-Verbs
feuilleter	to leaf through	[sound:feuilleter.mp3]	Standard-Verbs
fixer 	to fix, set	[sound:fixer+.mp3]	Standard-Verbs
fonder	to found, establish, lay the foundation, 	[sound:fonder.mp3]	Standard-Verbs
fondre	to melt, dissolve, mix colors	[sound:fondre.mp3]	Standard-Verbs
fouiller	to dig deeply, excavate, search	[sound:fouiller.mp3]	Standard-Verbs
fournir	to furnish, supply	[sound:fournir.mp3]	Standard-Verbs
frapper	to knock, hit, strike, rap 	[sound:frapper.mp3]	Standard-Verbs
frémir	to shudder, quiver, tremble	[sound:fr%C3%A9mir.mp3]	Standard-Verbs
frire 	to deep-fry	[sound:frire+.mp3]	Standard-Verbs
gaspiller	to waste	[sound:gaspiller.mp3]	Standard-Verbs
gâter	to spoil, damage	[sound:g%C3%A2ter.mp3]	Standard-Verbs
geindre	to moan 	[sound:geindre.mp3]	Standard-Verbs
geler	to freeze	[sound:geler.mp3]	Standard-Verbs
gêner	to bother, hamper, constrict, embarass, hinder, impede, inconvenience	[sound:g%C3%AAner.mp3]	Standard-Verbs
gérer	to manage	[sound:g%C3%A9rer.mp3]	Standard-Verbs
grandir	to grow (up, taller), increase	[sound:grandir.mp3]	Standard-Verbs
gratter	to grate, scrape, scratch	[sound:gratter.mp3]	Standard-Verbs
grêler	to hail (ice from the sky)	[sound:gr%C3%AAler.mp3]	Standard-Verbs
grimper	to climb	[sound:grimper.mp3]	Standard-Verbs
gronder	to chide, reprimand, scold	[sound:gronder.mp3]	Standard-Verbs
guérir	to cure, heal, remedy, recover	[sound:gu%C3%A9rir.mp3]	Standard-Verbs
s'habiller	to get dressed, to dress (onself)	[sound:s%27habiller.mp3]	Standard-Verbs
habiter	to live (in), dwell (in), inhabit	[sound:habiter.mp3]	Standard-Verbs
hésiter	to hesitate	[sound:h%C3%A9siter.mp3]	Standard-Verbs
hoqueter	to hiccup, gasp	[sound:hoqueter.mp3]	Standard-Verbs
ignorer	to be unaware of, to be unaware of, to ignore	[sound:ignorer.mp3]	Standard-Verbs
imposer	to impose	[sound:imposer.mp3]	Standard-Verbs
indiquer	to incidate, point out, show	[sound:indiquer.mp3]	Standard-Verbs
induire	to mislead	[sound:induire.mp3]	Standard-Verbs
s'informer	to find out, inquire, inform oneself	[sound:s%27informer.mp3]	Standard-Verbs
compter	to count, intend, expect to	[sound:compter.mp3]	Standard-Verbs
concevoir	to conceive	[sound:concevoir.mp3]	Standard-Verbs
conclure	to conclude	[sound:conclure.mp3]	Standard-Verbs
concourir	to compete (concurrently)	[sound:concourir.mp3]	Standard-Verbs
conduire	to lead, drive, conduct, manage	[sound:conduire.mp3]	Standard-Verbs
conserver	to preserve, conserve	[sound:conserver.mp3]	Standard-Verbs
confondre	to confuse, confound	[sound:confondre.mp3]	Standard-Verbs
conjoindre	to conjoin, unite	[sound:conjoindre.mp3]	Standard-Verbs
conquérir	to conquer	[sound:conqu%C3%A9rir.mp3]	Standard-Verbs
conseiller	to advise, counsel, recommend	[sound:conseiller.mp3]	Standard-Verbs
consentir	to consent, agree	[sound:consentir.mp3]	Standard-Verbs
considérer	to consider	[sound:consid%C3%A9rer.mp3]	Standard-Verbs
consommer	to consume (drink, eat), consummate	[sound:consommer.mp3]	Standard-Verbs
construire	to construct, build	[sound:construire.mp3]	Standard-Verbs
contenir	to contain<br />to fit	[sound:contenir.mp3]	Standard-Verbs
conter	to relate, narrate, recount	[sound:conter.mp3]	Standard-Verbs
contraindre	to constrain, restrain, compel	[sound:contraindre.mp3]	Standard-Verbs
contredire	to contradict	[sound:contredire.mp3]	Standard-Verbs
contrevenir	to contravene	[sound:contrevenir.mp3]	Standard-Verbs
convaincre	to convince	[sound:convaincre.mp3]	Standard-Verbs
convenir	to suit, be appropriate<br>to agree, acknowledge	[sound:convenir.mp3]	Standard-Verbs
correspondre	to correspond (as in write, and to fit, relate)	[sound:correspondre.mp3]	Standard-Verbs
corrompre	to corrupt	[sound:corrompre.mp3]	Standard-Verbs
coudre	to sew, stitch	[sound:coudre.mp3]	Standard-Verbs
couvrir	to cover	[sound:couvrir.mp3]	Standard-Verbs
craindre	to fear	[sound:craindre.mp3]	Standard-Verbs
créer	to create	[sound:cr%C3%A9er.mp3]	Standard-Verbs
crier	to shout, cry out	[sound:crier.mp3]	Standard-Verbs
cueillir	to gather, pick	[sound:cueillir.mp3]	Standard-Verbs
culpabiliser	to make one feel guilty	[sound:culpabiliser.mp3]	Standard-Verbs
danser	to dance	[sound:danser.mp3]	Standard-Verbs
débattre	to debate, discuss	[sound:d%C3%A9battre.mp3]	Standard-Verbs
décevoir	to deceive, disappoint	[sound:d%C3%A9cevoir.mp3]	Standard-Verbs
déchirer	to rip	[sound:d%C3%A9chirer.mp3]	Standard-Verbs
décorer	to decorate	[sound:d%C3%A9corer.mp3]	Standard-Verbs
découdre	to take the stitches out of<br>to take off/out, to come off	[sound:d%C3%A9coudre.mp3]	Standard-Verbs
décourager	to discourage	[sound:d%C3%A9courager.mp3]	Standard-Verbs
découvrir	to discover, uncover	[sound:d%C3%A9couvrir.mp3]	Standard-Verbs
se dédire	to retract	[sound:se+d%C3%A9dire.mp3]	Standard-Verbs
déduire	to deduce, infer, deduct	[sound:d%C3%A9duire.mp3]	Standard-Verbs
défaillir	to faint, falter	[sound:d%C3%A9faillir.mp3]	Standard-Verbs
défaire	to undo, untie	[sound:d%C3%A9faire.mp3]	Standard-Verbs
défendre	to defend, forbid, prohibit	[sound:d%C3%A9fendre.mp3]	Standard-Verbs
défricher	to clear, open up, prepare the ground	[sound:d%C3%A9fricher.mp3]	Standard-Verbs
dégager	to free, clear (out), remove<br>to give off, emit	[sound:d%C3%A9gager.mp3]	Standard-Verbs
déjeuner	to have lunch or breakfast	[sound:d%C3%A9jeuner.mp3]	Standard-Verbs
déménager	to move (furniture, etc.)	[sound:d%C3%A9m%C3%A9nager.mp3]	Standard-Verbs
demeurer	to reside, live, remain, stay	[sound:demeurer.mp3]	Standard-Verbs
démolir	to demolish	[sound:d%C3%A9molir.mp3]	Standard-Verbs
dénoncer	to denounce, terminate	[sound:d%C3%A9noncer.mp3]	Standard-Verbs
dépasser	to pass, go beyond, exceed	[sound:d%C3%A9passer.mp3]	Standard-Verbs
dépeindre	to depict, describe, portray	[sound:d%C3%A9peindre.mp3]	Standard-Verbs
dépendre	to depend (on)<br>to be dependent (on)<br>to take down (something that is hanging)	[sound:d%C3%A9pendre.mp3]	Standard-Verbs
dépenser	to spend (money)	[sound:d%C3%A9penser.mp3]	Standard-Verbs
déplaire	to displease	[sound:d%C3%A9plaire.mp3]	Standard-Verbs
déranger	to disturb, derange	[sound:d%C3%A9ranger.mp3]	Standard-Verbs
désirer	to desire<br />	[sound:d%C3%A9sirer.mp3]	Standard-Verbs
désobéir	to disobey	[sound:d%C3%A9sob%C3%A9ir.mp3]	Standard-Verbs
dessiner	to draw, sketch	[sound:dessiner.mp3]	Standard-Verbs
déteindre	to take the color out of <br>to fade, rub off	[sound:d%C3%A9teindre.mp3]	Standard-Verbs
détenir	to hold, detain<br>to be in power	[sound:d%C3%A9tenir.mp3]	Standard-Verbs
détourner	to turn aside, turn away, divert	[sound:d%C3%A9tourner.mp3]	Standard-Verbs
détruire	to destroy	[sound:d%C3%A9truire.mp3]	Standard-Verbs
développer	to develop, spread out	[sound:d%C3%A9velopper.mp3]	Standard-Verbs
dévêtir	to undress	[sound:d%C3%A9v%C3%AAtir.mp3]	Standard-Verbs
deviner	to guess	[sound:deviner.mp3]	Standard-Verbs
diminuer	to diminish, decrease, lesson	[sound:diminuer.mp3]	Standard-Verbs
dîner	to dine (have dinner)	[sound:d%C3%AEner.mp3]	Standard-Verbs
diriger	to run, manage, lead, conduct, steer, pilot, direct, supervice	[sound:diriger.mp3]	Standard-Verbs
discourir	to make a speech (discourse)	[sound:discourir.mp3]	Standard-Verbs
discuter	to discuss, argue	[sound:discuter.mp3]	Standard-Verbs
disparaître	to disappear	[sound:dispara%C3%AEtre.mp3]	Standard-Verbs
dissoudre	to dissolve, disband	[sound:dissoudre.mp3]	Standard-Verbs
divorcer	to get divorced	[sound:divorcer.mp3]	Standard-Verbs
doubler	to double, repeat, dub	[sound:doubler.mp3]	Standard-Verbs
échapper	to escape, avoid	[sound:%C3%A9chapper.mp3]	Standard-Verbs
échouer	to fail, run aground	[sound:%C3%A9chouer.mp3]	Standard-Verbs
éclore	to open, hatch	[sound:%C3%A9clore.mp3]	Standard-Verbs
éconduire	to dismiss, reject, turn away	[sound:%C3%A9conduire.mp3]	Standard-Verbs
écraser	to crush, squash, stub out, mash, grind, pound, flatten	[sound:%C3%A9craser.mp3]	Standard-Verbs
effrayer	to frighten	[sound:effrayer.mp3]	Standard-Verbs
égayer	to amuse, cheer up, enliven, entertain	[sound:%C3%A9gayer.mp3]	Standard-Verbs
retirer	to draw (out) again, pull again, take something out/off	[sound:retirer.mp3]	Standard-Verbs
inscrire	to note down, score	[sound:inscrire.mp3]	Standard-Verbs
insister	to insist	[sound:insister.mp3]	Standard-Verbs
instruire	to instruct	[sound:instruire.mp3]	Standard-Verbs
interdire	to forbid, prohibit	[sound:interdire.mp3]	Standard-Verbs
s'intéresser	to be interested in	[sound:s%27int%C3%A9resser.mp3]	Standard-Verbs
interroger	to question, ask, interrogate	[sound:interroger.mp3]	Standard-Verbs
interrompre	to interrupt	[sound:interrompre.mp3]	Standard-Verbs
intervenir	to intervene, play a part, give a talk	[sound:intervenir.mp3]	Standard-Verbs
introduire	to introduce, show in	[sound:introduire.mp3]	Standard-Verbs
inventer	to invent, devise, make up	[sound:inventer.mp3]	Standard-Verbs
jaillir	to spurt out, gush out, flow, ring out, spring out, shoot out	[sound:jaillir.mp3]	Standard-Verbs
jaser	to chatter	[sound:jaser.mp3]	Standard-Verbs
jaunir	to turn yellow	[sound:jaunir.mp3]	Standard-Verbs
jeter	to throw, cast	[sound:jeter.mp3]	Standard-Verbs
joindre	to join, contact	[sound:joindre.mp3]	Standard-Verbs
jouir	to enjoy	[sound:jouir.mp3]	Standard-Verbs
juger	to judge, deem	[sound:juger.mp3]	Standard-Verbs
jurer	to swear, vow	[sound:jurer.mp3]	Standard-Verbs
kidnapper	to kidnap	[sound:kidnapper.mp3]	Standard-Verbs
klaxonner	to honk	[sound:klaxonner.mp3]	Standard-Verbs
lâcher	to loosen, unleash, let go	[sound:l%C3%A2cher.mp3]	Standard-Verbs
laisser	to let, allow, leave (alone)	[sound:laisser.mp3]	Standard-Verbs
lancer	to hurl, launch, throw	[sound:lancer.mp3]	Standard-Verbs
loger	to live, lodge	[sound:loger.mp3]	Standard-Verbs
louer	to praise, rent, rent out	[sound:louer.mp3]	Standard-Verbs
luire	to shine, glisten, glimmer, twinkle	[sound:luire.mp3]	Standard-Verbs
maigrir	to lose weight, grow thin	[sound:maigrir.mp3]	Standard-Verbs
maintenir	to maintain, support	[sound:maintenir.mp3]	Standard-Verbs
manquer	to miss, lack	[sound:manquer.mp3]	Standard-Verbs
marcher	to walk, march, run (machine), function	[sound:marcher.mp3]	Standard-Verbs
maudire	to curse	[sound:maudire.mp3]	Standard-Verbs
méconnaître	to misjudge, misunderstand, not to know, not to recognize	[sound:m%C3%A9conna%C3%AEtre.mp3]	Standard-Verbs
médire	to malign, slander	[sound:m%C3%A9dire.mp3]	Standard-Verbs
mélanger	to mix, blend, shuffle	[sound:m%C3%A9langer.mp3]	Standard-Verbs
menacer	to threaten	[sound:menacer.mp3]	Standard-Verbs
mener	to lead, control	[sound:mener.mp3]	Standard-Verbs
mentir	to lie	[sound:mentir.mp3]	Standard-Verbs
mépriser	to despise, scorn	[sound:m%C3%A9priser.mp3]	Standard-Verbs
mériter	to deserve, to call for, merit	[sound:m%C3%A9riter.mp3]	Standard-Verbs
mesurer	to measure	[sound:mesurer.mp3]	Standard-Verbs
modérer	to moderate, restrain, reduce	[sound:mod%C3%A9rer.mp3]	Standard-Verbs
montrer	to show, display, exhibit, point out	[sound:montrer.mp3]	Standard-Verbs
moquer	to mock, make fun of	[sound:moquer.mp3]	Standard-Verbs
mordre	to bite	[sound:mordre.mp3]	Standard-Verbs
moudre	to mill, grind	[sound:moudre.mp3]	Standard-Verbs
mouiller	to get something wet, dampen, baste, drop anchor	[sound:mouiller.mp3]	Standard-Verbs
naviguer	to navigate, sail, browse, surf (internet)	[sound:naviguer.mp3]	Standard-Verbs
négliger	to neglect, be careless about, pay no attention to	[sound:n%C3%A9gliger.mp3]	Standard-Verbs
négocier	to negotiate	[sound:n%C3%A9gocier.mp3]	Standard-Verbs
neutraliser	to neutralize, overpower	[sound:neutraliser.mp3]	Standard-Verbs
nier	to deny	[sound:nier.mp3]	Standard-Verbs
noircir	to blacken, dirty, darken	[sound:noircir.mp3]	Standard-Verbs
nommer	to name, appoint	[sound:nommer.mp3]	Standard-Verbs
nouer	to tie, knot	[sound:nouer.mp3]	Standard-Verbs
nourrir	to feed, nourish	[sound:nourrir.mp3]	Standard-Verbs
se noyer	to drown	[sound:se+noyer.mp3]	Standard-Verbs
nuire	to harm, hinder	[sound:nuire.mp3]	Standard-Verbs
obliger	to oblige	[sound:obliger.mp3]	Standard-Verbs
omettre	to omit	[sound:omettre.mp3]	Standard-Verbs
oser	to dare	[sound:oser.mp3]	Standard-Verbs
paraître	to appear, seem	[sound:para%C3%AEtre.mp3]	Standard-Verbs
parcourir	to cover, travel up and down, go all over	[sound:parcourir.mp3]	Standard-Verbs
partager	to divide up, share	[sound:partager.mp3]	Standard-Verbs
participer	to participate, take part in, be involved in	[sound:participer.mp3]	Standard-Verbs
patiner	to skate	[sound:patiner.mp3]	Standard-Verbs
pécher	to sin	[sound:p%C3%A9cher.mp3]	Standard-Verbs
pêcher	to fish	[sound:p%C3%AAcher.mp3]	Standard-Verbs
se peigner	to comb one's hair	[sound:se+peigner.mp3]	Standard-Verbs
peindre	to paint, portray	[sound:peindre.mp3]	Standard-Verbs
peler	to peel	[sound:peler.mp3]	Standard-Verbs
pendre	to hang, suspend	[sound:pendre.mp3]	Standard-Verbs
pénétrer	to enter, penetrate	[sound:p%C3%A9n%C3%A9trer.mp3]	Standard-Verbs
percevoir	to perceive, detect, feel	[sound:percevoir.mp3]	Standard-Verbs
périr	to perish, die	[sound:p%C3%A9rir.mp3]	Standard-Verbs
permettre	to permit, allow, let	[sound:permettre.mp3]	Standard-Verbs
persuader	to persuade, convince, induce	[sound:persuader.mp3]	Standard-Verbs
peser	to weigh	[sound:peser.mp3]	Standard-Verbs
pianoter	to tap (like a piano), drum one's fingers	[sound:pianoter.mp3]	Standard-Verbs
plaindre	to pity	[sound:plaindre.mp3]	Standard-Verbs
plaire	to please	[sound:plaire.mp3]	Standard-Verbs
plaisanter	to joke (2)	[sound:plaisanter.mp3]	Standard-Verbs
planter	to plant, stick, dump	[sound:planter.mp3]	Standard-Verbs
plier	to fold, bend	[sound:plier.mp3]	Standard-Verbs
plonger	to dive, swoop, plummet	[sound:plonger.mp3]	Standard-Verbs
pondre	to lay (an egg)	[sound:pondre.mp3]	Standard-Verbs
poser	to lay, place, put, set, pose	[sound:poser.mp3]	Standard-Verbs
posséder	to possess, own, master	[sound:poss%C3%A9der.mp3]	Standard-Verbs
poursuivre	to pursue, prosecute	[sound:poursuivre.mp3]	Standard-Verbs
pousser	to push, grow	[sound:pousser.mp3]	Standard-Verbs
prédire	to predict, foretell	[sound:pr%C3%A9dire.mp3]	Standard-Verbs
préparer	to prepare	[sound:pr%C3%A9parer.mp3]	Standard-Verbs
prescrire	to prescribe, recommend	[sound:prescrire.mp3]	Standard-Verbs
présenter	to present, introduce	[sound:pr%C3%A9senter.mp3]	Standard-Verbs
pressentir	to sense, have a premonition	[sound:pressentir.mp3]	Standard-Verbs
presser	to press, squeeze	[sound:presser.mp3]	Standard-Verbs
prétendre	to pretend, claim, maintain	[sound:pr%C3%A9tendre.mp3]	Standard-Verbs
prêter	to lend	[sound:pr%C3%AAter.mp3]	Standard-Verbs
se prévaloir	to pride onself on	[sound:se+pr%C3%A9valoir.mp3]	Standard-Verbs
prévenir	to warn, forestall, ward off, prevent	[sound:pr%C3%A9venir.mp3]	Standard-Verbs
prévoir	to foresee	[sound:pr%C3%A9voir.mp3]	Standard-Verbs
prier	to pray, supplicate, entreat beg, request	[sound:prier.mp3]	Standard-Verbs
produire	to produce	[sound:produire.mp3]	Standard-Verbs
projeter	to project, plan, throw up, cast	[sound:projeter.mp3]	Standard-Verbs
prononcer	to pronounce, declare	[sound:prononcer.mp3]	Standard-Verbs
proscrire	to prohibit, ban, proscribe, banish	[sound:proscrire.mp3]	Standard-Verbs
protéger	to protect	[sound:prot%C3%A9ger.mp3]	Standard-Verbs
prouver	to prove	[sound:prouver.mp3]	Standard-Verbs
puer	to stink	[sound:puer.mp3]	Standard-Verbs
punir	to punish	[sound:punir.mp3]	Standard-Verbs
ralentir	to slow down	[sound:ralentir.mp3]	Standard-Verbs
ranger	to set (put) in order, tidy up	[sound:ranger.mp3]	Standard-Verbs
rappeler	to recall, remind, call again, call back	[sound:rappeler.mp3]	Standard-Verbs
rassurer	to reassure	[sound:rassurer.mp3]	Standard-Verbs
rater	to fail, miss<br />	[sound:rater.mp3]	Standard-Verbs
ravir	to delight, rob (somebody of something)	[sound:ravir.mp3]	Standard-Verbs
reconduire	to escort, renew	[sound:reconduire.mp3]	Standard-Verbs
reconstruire	to rebuild, reconstruct	[sound:reconstruire.mp3]	Standard-Verbs
recoudre	to sew back on, stitch up	[sound:recoudre.mp3]	Standard-Verbs
recourir	to race again, resort to, to turn to	[sound:recourir.mp3]	Standard-Verbs
recouvrir	to cover, become covered	[sound:recouvrir.mp3]	Standard-Verbs
récrire	to rewrite, write again	[sound:r%C3%A9crire.mp3]	Standard-Verbs
recueillir	to collect, gather, harvest	[sound:recueillir.mp3]	Standard-Verbs
rédiger	to write, compile, write up, draw up	[sound:r%C3%A9diger.mp3]	Standard-Verbs
redire	to repeat, say again	[sound:redire.mp3]	Standard-Verbs
réduire	to reduce, decrease, diminish	[sound:r%C3%A9duire.mp3]	Standard-Verbs
réélire	to re-elect	[sound:r%C3%A9%C3%A9lire.mp3]	Standard-Verbs
rejeter	to reject, throw back, deny	[sound:rejeter.mp3]	Standard-Verbs
rejoindre	to rejoin, to agree with	[sound:rejoindre.mp3]	Standard-Verbs
relire	to reread	[sound:relire.mp3]	Standard-Verbs
remarquer	to remark, notice, observe, distinguish	[sound:remarquer.mp3]	Standard-Verbs
remettre	to put (on) again, replace, put back, give back, postpone	[sound:remettre.mp3]	Standard-Verbs
rencontrer	to meet, encounter	[sound:rencontrer.mp3]	Standard-Verbs
rendre	to give back, return, render, vomit	[sound:rendre.mp3]	Standard-Verbs
renoncer	to renounce	[sound:renoncer.mp3]	Standard-Verbs
renouveler	to renew, re-elect, repeat	[sound:renouveler.mp3]	Standard-Verbs
renvoyer	to dismiss, expel, suspend, send away	[sound:renvoyer.mp3]	Standard-Verbs
répandre	to spread, scatter, spill	[sound:r%C3%A9pandre.mp3]	Standard-Verbs
reparaître	to reappear	[sound:repara%C3%AEtre.mp3]	Standard-Verbs
réparer	to repair	[sound:r%C3%A9parer.mp3]	Standard-Verbs
repasser	to iron, pass again	[sound:repasser.mp3]	Standard-Verbs
repeindre	to repaint	[sound:repeindre.mp3]	Standard-Verbs
se repentir	to repent	[sound:se+repentir.mp3]	Standard-Verbs
repérer	to spot, locate	[sound:rep%C3%A9rer.mp3]	Standard-Verbs
reprendre	to take back, recover, resume	[sound:reprendre.mp3]	Standard-Verbs
réprimander	to reprimand	[sound:r%C3%A9primander.mp3]	Standard-Verbs
reproduire	to reproduce	[sound:reproduire.mp3]	Standard-Verbs
résoudre	to resolve, solve	[sound:r%C3%A9soudre.mp3]	Standard-Verbs
ressembler	to resemble	[sound:ressembler.mp3]	Standard-Verbs
ressentir	to feel	[sound:ressentir.mp3]	Standard-Verbs
restreindre	to restrict	[sound:restreindre.mp3]	Standard-Verbs
retenir	to retain, keep, detain, hold back	[sound:retenir.mp3]	Standard-Verbs
revendiquer	to demand, claim responsibility for, claim	[sound:revendiquer.mp3]	Standard-Verbs
rêver	to dream (during sleep)	[sound:r%C3%AAver.mp3]	Standard-Verbs
revêtir	to put on (uniform)<br>to take on (appearance, character)	[sound:rev%C3%AAtir.mp3]	Standard-Verbs
revoir	to see again	[sound:revoir.mp3]	Standard-Verbs
riposter	to retaliate, answer back, counter attack	[sound:riposter.mp3]	Standard-Verbs
rire	to laugh	[sound:rire.mp3]	Standard-Verbs
rompre	to break, burst, shatter, break off	[sound:rompre.mp3]	Standard-Verbs
rougir	to redden, blush	[sound:rougir.mp3]	Standard-Verbs
rouler	to roll, drive (a car), ride along	[sound:rouler.mp3]	Standard-Verbs
rouvrir	to reopen	[sound:rouvrir.mp3]	Standard-Verbs
saisir	to seize, grasp, comprehend	[sound:saisir.mp3]	Standard-Verbs
salir	to soil, dirty	[sound:salir.mp3]	Standard-Verbs
satisfaire	to satisfy	[sound:satisfaire.mp3]	Standard-Verbs
sauter	to jump, leap	[sound:sauter.mp3]	Standard-Verbs
sauver	to save, rescue	[sound:sauver.mp3]	Standard-Verbs
secouer	to shake, shake off	[sound:secouer.mp3]	Standard-Verbs
secourir	to help, relieve	[sound:secourir.mp3]	Standard-Verbs
séduire	to charm, appeal to	[sound:s%C3%A9duire.mp3]	Standard-Verbs
séjourner	to sojourn, live somewhere temporarily	[sound:s%C3%A9journer.mp3]	Standard-Verbs
sembler	to seem	[sound:sembler.mp3]	Standard-Verbs
séparer	to separate	[sound:s%C3%A9parer.mp3]	Standard-Verbs
serrer	to grasp, press, squeeze, shake (hands)	[sound:serrer.mp3]	Standard-Verbs
servir	to serve, be useful	[sound:servir.mp3]	Standard-Verbs
siffler	to whistle, hiss, boo	[sound:siffler.mp3]	Standard-Verbs
signaler	to signal, point out	[sound:signaler.mp3]	Standard-Verbs
signer	to sign	[sound:signer.mp3]	Standard-Verbs
signifier	to mean	[sound:signifier.mp3]	Standard-Verbs
skier	to ski	[sound:skier.mp3]	Standard-Verbs
songer	to dream, think	[sound:songer.mp3]	Standard-Verbs
sonner	to ring	[sound:sonner.mp3]	Standard-Verbs
souffler	to blow, pant	[sound:souffler.mp3]	Standard-Verbs
souffrir	to suffer, endure	[sound:souffrir.mp3]	Standard-Verbs
souiller	to soil, dirty, muddy, sully (reputation)	[sound:souiller.mp3]	Standard-Verbs
soumettre	to submit	[sound:soumettre.mp3]	Standard-Verbs
sourire	to smile	[sound:sourire.mp3]	Standard-Verbs
souscrire	to subscribe (book, new publication, fund)	[sound:souscrire.mp3]	Standard-Verbs
soutenir	to support	[sound:soutenir.mp3]	Standard-Verbs
se souvenir	to remember	[sound:se+souvenir.mp3]	Standard-Verbs
subir	to suffer, undergo	[sound:subir.mp3]	Standard-Verbs
subvenir	to provide for, support	[sound:subvenir.mp3]	Standard-Verbs
sucer	to suck	[sound:sucer.mp3]	Standard-Verbs
succomber	to succumb, die	[sound:succomber.mp3]	Standard-Verbs
suffire	to suffice, be enough	[sound:suffire.mp3]	Standard-Verbs
suggérer	to suggest	[sound:sugg%C3%A9rer.mp3]	Standard-Verbs
supplier	to beg, implore, supplicate	[sound:supplier.mp3]	Standard-Verbs
supposer	to suppose	[sound:supposer.mp3]	Standard-Verbs
supporter	to support, endure, hold up, prop up, tolerate	[sound:supporter.mp3]	Standard-Verbs
surprendre	to surprise	[sound:surprendre.mp3]	Standard-Verbs
survenir	to occur, arise, take place	[sound:survenir.mp3]	Standard-Verbs
survivre	to survive	[sound:survivre.mp3]	Standard-Verbs
survoler	to fly over	[sound:survoler.mp3]	Standard-Verbs
tapoter	to tap, pat	[sound:tapoter.mp3]	Standard-Verbs
teindre	to dye	[sound:teindre.mp3]	Standard-Verbs
téléphoner	to call (on the telephone)	[sound:t%C3%A9l%C3%A9phoner.mp3]	Standard-Verbs
tendre	to strain, stretch, tighten, tend	[sound:tendre.mp3]	Standard-Verbs
tenter	to tempt, attempt, try	[sound:tenter.mp3]	Standard-Verbs
tirer	to draw out, shoot, pull	[sound:tirer.mp3]	Standard-Verbs
tondre	to shear, mow	[sound:tondre.mp3]	Standard-Verbs
tonner	to thunder, boom	[sound:tonner.mp3]	Standard-Verbs
tordre	to twist	[sound:tordre.mp3]	Standard-Verbs
toucher	to touch, affect	[sound:toucher.mp3]	Standard-Verbs
tourner	to turn	[sound:tourner.mp3]	Standard-Verbs
tousser	to cough	[sound:tousser.mp3]	Standard-Verbs
tracer	to draw (something out: water, card, etc.)<br>to draw (plan, line, circle)	[sound:tracer.mp3]	Standard-Verbs
traduire	to translate	[sound:traduire.mp3]	Standard-Verbs
trahir	to betray	[sound:trahir.mp3]	Standard-Verbs
traiter	to treat (somebody a certain way), negotiate	[sound:traiter.mp3]	Standard-Verbs
transmettre	to transmit, transfer	[sound:transmettre.mp3]	Standard-Verbs
transparaître	to show through	[sound:transpara%C3%AEtre.mp3]	Standard-Verbs
traverser	to traverse, cross	[sound:traverser.mp3]	Standard-Verbs
tressaillir	to quiver, shudder, wince	[sound:tressaillir.mp3]	Standard-Verbs
tricher	to trick, cheat	[sound:tricher.mp3]	Standard-Verbs
tuer	to kill	[sound:tuer.mp3]	Standard-Verbs
tutoyer	to use &quot;tu&quot; with somebody when speaking	[sound:tutoyer.mp3]	Standard-Verbs
unir	to unite, join	[sound:unir.mp3]	Standard-Verbs
user	to wear out, wear down	[sound:user.mp3]	Standard-Verbs
vaincre	to vanquish, conquer	[sound:vaincre.mp3]	Standard-Verbs
valoir	to be worth, be as good as, deserve, merit	[sound:valoir.mp3]	Standard-Verbs
vanter	to vaunt, praise	[sound:vanter.mp3]	Standard-Verbs
varier	to vary	[sound:varier.mp3]	Standard-Verbs
veiller	to stay up (late), be watchful	[sound:veiller.mp3]	Standard-Verbs
venger	to avenge	[sound:venger.mp3]	Standard-Verbs
verdir	to turn green	[sound:verdir.mp3]	Standard-Verbs
vérifier	to verify, check, audit	[sound:v%C3%A9rifier.mp3]	Standard-Verbs
verser	to pour	[sound:verser.mp3]	Standard-Verbs
vêtir	to clothe, dress	[sound:v%C3%AAtir.mp3]	Standard-Verbs
vieillir	to grow old, age	[sound:vieillir.mp3]	Standard-Verbs
viser	to aim	[sound:viser.mp3]	Standard-Verbs
vivre	to live (be alive)	[sound:vivre.mp3]	Standard-Verbs
voiler	to veil	[sound:voiler.mp3]	Standard-Verbs
voler	to fly, steal	[sound:voler.mp3]	Standard-Verbs
voter	to vote	[sound:voter.mp3]	Standard-Verbs
vouvoyer	to use &quot;vous&quot; when speaking with somebody	[sound:vouvoyer.mp3]	Standard-Verbs
voyager	to travel	[sound:voyager.mp3]	Standard-Verbs
zébrer	to stripe	[sound:z%C3%A9brer.mp3]	Standard-Verbs
zézayer	to lisp	[sound:z%C3%A9zayer.mp3]	Standard-Verbs
zoner	to zone	[sound:zoner.mp3]	Standard-Verbs
frissonner	to quake (fear), shudder (horror), shiver (from cold)	[sound:frissonner.mp3]	Standard-Verbs
rêvasser	to dream (when awake)	[sound:r%C3%AAvasser.mp3]	Standard-Verbs
accroître	to increase, make greater, to enlarge	[sound:accro%C3%AEtre.mp3]	Standard-Verbs
s'en aller	to go away	[sound:s%27en+aller.mp3]	Standard-Verbs
s'amuser	to have a good time<br>to amuse oneself<br>to enjoy oneself	[sound:s%27amuser.mp3]	Standard-Verbs
apprécier	to appreciate	[sound:appr%C3%A9cier.mp3]	Standard-Verbs
s'arrêter	to stop oneself, to pause	[sound:s%27arr%C3%AAter.mp3]	Standard-Verbs
assiéger	to besiege<br />to lay seige to	[sound:assi%C3%A9ger.mp3]	Standard-Verbs
baver	to drool	[sound:baver.mp3]	Standard-Verbs
brancher	to plug in, connect	[sound:brancher.mp3]	Standard-Verbs
croître	to grow, increase	[sound:cro%C3%AEtre.mp3]	Standard-Verbs
se débrouiller	to manage, improvise, get by	[sound:se+d%C3%A9brouiller.mp3]	Standard-Verbs
décroître	to decrease, diminish	[sound:d%C3%A9cro%C3%AEtre.mp3]	Standard-Verbs
se dépêcher	to hurry, hasten	[sound:se+d%C3%A9p%C3%AAcher.mp3]	Standard-Verbs
émouvoir	to move, touch, excite, arouse	[sound:%C3%A9mouvoir.mp3]	Standard-Verbs
enduire	to coat (cover a surface)	[sound:enduire.mp3]	Standard-Verbs
s'étendre	to stretch oneself, to stretch out, lie down	[sound:s%27%C3%A9tendre.mp3]	Standard-Verbs
s'évanouir	to faint, lose consciousness, swoon, vanish	[sound:s%27%C3%A9vanouir.mp3]	Standard-Verbs
s'exclure mutuellement	to be mutually exclusive	[sound:s%27exclure+mutuellement.mp3]	Standard-Verbs
s'excuser	to excuse oneself, apologize	[sound:s%27excuser.mp3]	Standard-Verbs
se fâcher	to become angry	[sound:se+f%C3%A2cher.mp3]	Standard-Verbs
se fier	to depend on, rely on, trust in	[sound:se+fier.mp3]	Standard-Verbs
fuir	to flee, fly off, shun<br />to leak (gas, oil, etc.)	[sound:fuir.mp3]	Standard-Verbs
se laver	to wash oneself	[sound:se+laver.mp3]	Standard-Verbs
se lever	to get up	[sound:se+lever.mp3]	Standard-Verbs
se méfier	to beware, distrust, mistrust	[sound:se+m%C3%A9fier.mp3]	Standard-Verbs
se méprendre	to be mistaken, to mistake	[sound:se+m%C3%A9prendre.mp3]	Standard-Verbs
se mettre	to begin, start, place oneself	[sound:se+mettre.mp3]	Standard-Verbs
mirer	to mirror	[sound:mirer.mp3]	Standard-Verbs
modeler	to model, shape	[sound:modeler.mp3]	Standard-Verbs
mouvoir	to move	[sound:mouvoir.mp3]	Standard-Verbs
s'occuper	to be busy, keep oneself busy	[sound:s%27occuper.mp3]	Standard-Verbs
se plaindre	to complain, lament, moan	[sound:se+plaindre.mp3]	Standard-Verbs
se presser	to be in a hurry, make haste, rush, crowd	[sound:se+presser.mp3]	Standard-Verbs
programmer	to program, plan	[sound:programmer.mp3]	Standard-Verbs
se rappeler	to remember, recall, recollect	[sound:se+rappeler.mp3]	Standard-Verbs
se reposer	to rest 	[sound:se+reposer.mp3]	Standard-Verbs
se retirer	to retire, withdraw	[sound:se+retirer.mp3]	Standard-Verbs
se sauver	to run away, to rush off, to escape	[sound:se+sauver.mp3]	Standard-Verbs
sécher	to dry	[sound:s%C3%A9cher.mp3]	Standard-Verbs
se servir	to serve oneself, help oneself (to food and drink)	[sound:se+servir.mp3]	Standard-Verbs
se taire	to be silent, quiet	[sound:se+taire.mp3]	Standard-Verbs
traire	to milk	[sound:traire.mp3]	Standard-Verbs
travailler	to work	[sound:travailler.mp3]	Standard-Verbs
se tromper	to be mistaken, to be wrong (about something)	[sound:se+tromper.mp3]	Standard-Verbs
tromper	to cheat, deceive	[sound:tromper.mp3]	Standard-Verbs
trouver	to find	[sound:trouver.mp3]	Standard-Verbs
se trouver	to be located, be situated	[sound:se+trouver.mp3]	Standard-Verbs
vendre	to sell	[sound:vendre.mp3]	Standard-Verbs
voir	to see	[sound:voir.mp3]	Standard-Verbs
déverrouiller	to unlock, release, unboldt	[sound:d%C3%A9verrouiller.mp3]	Standard-Verbs
détendre	to relax		
coopérer	to cooperate		
précéder	to precede		
régner	to reign		
rouspéter	to grumble, grouch		
tolérer	to tolerate		
ensorceler	to bewitch		
aboyer	to bark		
rayer	to cross out		
revendre	to sell, sell off		
grossir	to gain weight		