acheter	to buy	[sound:acheter.mp3]
advenir	to happen	[sound:advenir.mp3]
aider	to help, assist	[sound:aider.mp3]
aimer	to like, to love	[sound:aimer.mp3]
ajouter	to add	[sound:ajouter.mp3]
appeler	to call, name, appeal	[sound:appeler.mp3]
apporter	to bring, bear	[sound:apporter.mp3]
apprendre	to learn	[sound:apprendre.mp3]
arrêter	to stop, arrest	[sound:arr%C3%AAter.mp3]
attendre	to wait, wait for, expect	[sound:attendre.mp3]
connaître	to know, be acquainted	[sound:conna%C3%AEtre.mp3]
continuer	to continue	[sound:continuer.mp3]
contrôler	to check, inspect, test, supervise, control	[sound:contr%C3%B4ler.mp3]
corriger	to correct	[sound:corriger.mp3]
coucher	to put to bed, lay, flatten	[sound:coucher.mp3]
couper	to cut, switch off	[sound:couper.mp3]
courir	to run, race	[sound:courir.mp3]
coûter	to cost	[sound:co%C3%BBter.mp3]
croire	to believe	[sound:croire.mp3]
cuire	to cook	[sound:cuire.mp3]
décider	to decide	[sound:d%C3%A9cider.mp3]
décrire	to describe	[sound:d%C3%A9crire.mp3]
demander	to ask for	[sound:demander.mp3]
enlever	to carry away, take away, remove	[sound:enlever.mp3]
enseigner	to teach	[sound:enseigner.mp3]
entendre	to hear, understand	[sound:entendre.mp3]
envoyer	to send	[sound:envoyer.mp3]
espérer	to hope	[sound:esp%C3%A9rer.mp3]
essayer	to try	[sound:essayer.mp3]
étudier	to study	[sound:%C3%A9tudier.mp3]
inviter	to invite	[sound:inviter.mp3]
jouer	to play, act (in a play), gamble	[sound:jouer.mp3]
laver	to wash	[sound:laver.mp3]
lever	to lift, raise	[sound:lever.mp3]
lire	to read	[sound:lire.mp3]
manger	to eat	[sound:manger.mp3]
mettre	to put (set), put on, place<br /><br />*many different meanings, and very common with expressions	[sound:mettre.mp3]
nager	to swim	[sound:nager.mp3]
pleurer	to cry, weep, mourn	[sound:pleurer.mp3]
pleuvoir	to rain	[sound:pleuvoir.mp3]
porter	to wear, to carry	[sound:porter.mp3]
préférer	to prefer	[sound:pr%C3%A9f%C3%A9rer.mp3]
prendre	to take (as in grab, bring, take notes,etc).<br /><br />*many uses, very common in expressions	[sound:prendre.mp3]
se promener	to take a walk	[sound:se+promener.mp3]
promettre	promise	[sound:promettre.mp3]
proposer	to propose, suggest	[sound:proposer.mp3]
provenir	to be from, be the result of, be due to	[sound:provenir.mp3]
quitter	to leave, quit, split up	[sound:quitter.mp3]
raconter	to tell, recount	[sound:raconter.mp3]
recevoir	to receive, get	[sound:recevoir.mp3]
reconnaître	to recognize, acknowledge	[sound:reconna%C3%AEtre.mp3]
savoir	to know (how)	[sound:savoir.mp3]
sentir	to feel, smell, perceive	[sound:sentir.mp3]
souhaiter	to wish	[sound:souhaiter.mp3]
suivre	to follow	[sound:suivre.mp3]
susciter	to arouse, give rise to	[sound:susciter.mp3]
tenir	to hold, grasp	[sound:tenir.mp3]
terminer	to terminate, finish, end	[sound:terminer.mp3]
avoir besoin	to need	[sound:avoir+besoin.mp3]
blesser	to hurt, injure, wound, offend	[sound:blesser.mp3]
boire	to drink	[sound:boire.mp3]
brûler	to burn	[sound:br%C3%BBler.mp3]
cacher	to hide	[sound:cacher.mp3]
changer	to change	[sound:changer.mp3]
choisir	to choose, select, pick	[sound:choisir.mp3]
commencer	to begin, start, commence	[sound:commencer.mp3]
compléter	to make up, complete, complement, add to	[sound:compl%C3%A9ter.mp3]
comprendre	to understand<br>to include	[sound:comprendre.mp3]
dépêcher	to dispatch	[sound:d%C3%A9p%C3%AAcher.mp3]
détester	to detest, dislike, hate	[sound:d%C3%A9tester.mp3]
dire	to say, tell	[sound:dire.mp3]
donner 	to give	[sound:donner+.mp3]
dormir	to sleep	[sound:dormir.mp3]
douter	to doubt	[sound:douter.mp3]
écouter	to listen	[sound:%C3%A9couter.mp3]
écrire	to write	[sound:%C3%A9crire.mp3]
effacer	to erase, rub out, delete	[sound:effacer.mp3]
élever	to raise, rear, bring up	[sound:%C3%A9lever.mp3]
fermer	to close	[sound:fermer.mp3]
finir	to finish, end, terminate, complete	[sound:finir.mp3]
forcer	to force	[sound:forcer.mp3]
fumer	to smoke, steam	[sound:fumer.mp3]
gagner	to win, earn, gain	[sound:gagner.mp3]
garder	to guard, keep, retain	[sound:garder.mp3]
goûter	to taste, have a snack, enjoy	[sound:go%C3%BBter.mp3]
haïr	to hate	[sound:ha%C3%AFr.mp3]
inclure	to include, enclose	[sound:inclure.mp3]
s'inquiéter	to worry, to be upset	[sound:s%27inqui%C3%A9ter.mp3]
neiger	to snow	[sound:neiger.mp3]
nettoyer	to clean	[sound:nettoyer.mp3]
noter	to write down<br>to notice<br>to mark, grade, assess	[sound:noter.mp3]
obéir	to obey	[sound:ob%C3%A9ir.mp3]
obtenir	to obtain, to get	[sound:obtenir.mp3]
occuper	to occupy	[sound:occuper.mp3]
offrir	to offer	[sound:offrir.mp3]
oublier	to forget	[sound:oublier.mp3]
ouvrir	to open	[sound:ouvrir.mp3]
pardonner	to pardon, forgive	[sound:pardonner.mp3]
parler	to talk	[sound:parler.mp3]
payer	to pay	[sound:payer.mp3]
penser	to think	[sound:penser.mp3]
perdre	to lose (something, location, etc)	[sound:perdre.mp3]
placer 	to place, put	[sound:placer+.mp3]
refaire	to redo	[sound:refaire.mp3]
réfléchir	to think, meditate, reflect, ponder	[sound:r%C3%A9fl%C3%A9chir.mp3]
refuser	to refuse, withhold	[sound:refuser.mp3]
regarder	to look at, watch	[sound:regarder.mp3]
regretter	to regret, miss	[sound:regretter.mp3]
remercier	to thank	[sound:remercier.mp3]
remplacer	to replace	[sound:remplacer.mp3]
remplir	to fill	[sound:remplir.mp3]
répéter	to repeat. rehearse	[sound:r%C3%A9p%C3%A9ter.mp3]
répondre	to respond, reply, answer	[sound:r%C3%A9pondre.mp3]
réussir	to succeed, result	[sound:r%C3%A9ussir.mp3]
se réveiller	to wake up	[sound:se+r%C3%A9veiller.mp3]
révéler	to reveal, discover, bring to fame	[sound:r%C3%A9v%C3%A9ler.mp3]
aller	to go	[sound:aller.mp3]
arriver	to arrive<br />to happen	[sound:arriver.mp3]
entrer	to enter, come in, go in	[sound:entrer.mp3]
monter	to go up, climb, take up, bring up, mount	[sound:monter.mp3]
naître	to be born	[sound:na%C3%AEtre.mp3]
mourir	to die	[sound:mourir.mp3]
sortir	to go out, leave	[sound:sortir.mp3]
tomber	to fall	[sound:tomber.mp3]
descendre	to descend go down, take down, bring down	[sound:descendre.mp3]
devenir	to become	[sound:devenir.mp3]
partir	to leave, go away	[sound:partir.mp3]
parvenir	to reach, send, achieve	[sound:parvenir.mp3]
passer	to go, take, pass, spend time<br /><br />*numerous uses, common in expressions	[sound:passer.mp3]
rentrer	to return (to a place)	[sound:rentrer.mp3]
rester	to remain, stay, be left (over)	[sound:rester.mp3]
retourner	to return	[sound:retourner.mp3]
revenir	to come back	[sound:revenir.mp3]
venir	to come	[sound:venir.mp3]
avoir	to have	[sound:avoir.mp3]
être	to be	[sound:%C3%AAtre.mp3]
faire	to make, do	[sound:faire.mp3]
pouvoir	to be able, can	[sound:pouvoir.mp3]
devoir	to have to, must, ought, owe, should	[sound:devoir.mp3]
vouloir	to want	[sound:vouloir.mp3]
abaisser	to lower, reduce, humilitate, humble	[sound:abaisser.mp3]
abasourdir	to daze, deafen, stun, bewilder, stupefy	[sound:abasourdir.mp3]
abattre	to knock, pull, cut, shoot, or bring down, slaughter<br />to dishearten	[sound:abattre.mp3]
abolir	to abolish, do away with	[sound:abolir.mp3]
absoudre	to absolve	[sound:absoudre.mp3]
s'abstenir	to abstain	[sound:s%27abstenir.mp3]
accepter	to accept	[sound:accepter.mp3]
acclamer	to acclaim, cheer, applaud	[sound:acclamer.mp3]
accompagner	to accompany	[sound:accompagner.mp3]
accorder	to accord, grant, reconcile, admit	[sound:accorder.mp3]
accourir	to run to, run up to	[sound:accourir.mp3]
accrocher	to hang (up)	[sound:accrocher.mp3]
accueillir	to welcome	[sound:accueillir.mp3]
accuser	to accuse, acknowledge	[sound:accuser.mp3]
achever	to achieve, complete, finish, end	[sound:achever.mp3]
acquérir	to acquire	[sound:acqu%C3%A9rir.mp3]
adjoindre	to appoint (as on a team, position, etc.)	[sound:adjoindre.mp3]
admettre	to admit, pass, suppose	[sound:admettre.mp3]
admirer	to admire	[sound:admirer.mp3]
adorer	to adore, worship	[sound:adorer.mp3]
adresser	to address, send	[sound:adresser.mp3]
affaiblir	to weaken	[sound:affaiblir.mp3]
agacer	to annoy, irritate, pester, vex	[sound:agacer.mp3]
agir	to act/behave, take effect	[sound:agir.mp3]
aménager	to fit out, lay out, develop, plan, adjust	[sound:am%C3%A9nager.mp3]
amener	to bring<br />to lead<br /> <br />*<b>amener</b> is generally used with people, <b>apporter</b> with things.	[sound:amener.mp3]
amuser	to amuse, entertain	[sound:amuser.mp3]
animer	to host, present, lead, bring to life, drive, sustain	[sound:animer.mp3]
annoncer	to announce	[sound:annoncer.mp3]
apercevoir	to perceive	[sound:apercevoir.mp3]
apparaître	to appear	[sound:appara%C3%AEtre.mp3]
appartenir	to belong, pertain	[sound:appartenir.mp3]
mémoriser	to memorize	[sound:m%C3%A9moriser.mp3]
approcher	to approach, to come near, to bring near	[sound:approcher.mp3]
approuver	to approve (of)	[sound:approuver.mp3]
armer	to arm	[sound:armer.mp3]
arracher	to pull up/out, uproot	[sound:arracher.mp3]
arraisonner	to board	[sound:arraisonner.mp3]
arranger	to arrange	[sound:arranger.mp3]
assaillir	to assail, attack, beset	[sound:assaillir.mp3]
s'asseoir	to sit down	[sound:s%27asseoir.mp3]
assister	to attend<br>to assist (at)<br>to be present (at)	[sound:assister.mp3]
assurer	to assure, ensure, insure, guarantee	[sound:assurer.mp3]
astreindre	to compel, oblige	[sound:astreindre.mp3]
attaquer	to attack, contest, tackle, launch, start work on	[sound:attaquer.mp3]
atteindre	to attain	[sound:atteindre.mp3]
attirer	to attract, allure	[sound:attirer.mp3]
attraper	to catch	[sound:attraper.mp3]
augmenter	to augment, increase	[sound:augmenter.mp3]
avancer	to advance, go forward	[sound:avancer.mp3]
avoir raison	to be right	[sound:avoir+raison.mp3]
baisser	to lower, sink	[sound:baisser.mp3]
balancer	to sway, balance, swing<br />to weigh<br />to throw away	[sound:balancer.mp3]
balayer	to sweep	[sound:balayer.mp3]
bâtir	to build	[sound:b%C3%A2tir.mp3]
battre	to beat	[sound:battre.mp3]
bavarder	to chat	[sound:bavarder.mp3]
bêler	to whine (like a sheep)	[sound:b%C3%AAler.mp3]
bénir	to bless	[sound:b%C3%A9nir.mp3]
blaguer	to joke	[sound:blaguer.mp3]
blâmer	to blame	[sound:bl%C3%A2mer.mp3]
blanchir	to whiten, launder, exonerate	[sound:blanchir.mp3]
bouger	to budge, move	[sound:bouger.mp3]
bouillir	to boil	[sound:bouillir.mp3]
briser	to break, ruin (career, life), put an end to	[sound:briser.mp3]
brosser	to brush	[sound:brosser.mp3]
broyer	to grind	[sound:broyer.mp3]
casser	to break, crack, quash	[sound:casser.mp3]
causer	to chat, cause	[sound:causer.mp3]
céder	to yield, cede, give up	[sound:c%C3%A9der.mp3]
ceindre	to put on	[sound:ceindre.mp3]
célébrer	to celebrate	[sound:c%C3%A9l%C3%A9brer.mp3]
cesser	to cease	[sound:cesser.mp3]
chanter	to sing	[sound:chanter.mp3]
charger	to burden, charge, load	[sound:charger.mp3]
chasser	to hunt, chase, drive out	[sound:chasser.mp3]
cheminer	to walk along, follow its course	[sound:cheminer.mp3]
chercher	to look for	[sound:chercher.mp3]
chérir	to cherish	[sound:ch%C3%A9rir.mp3]
chuchoter	to whisper	[sound:chuchoter.mp3]
circoncire	to circumcise	[sound:circoncire.mp3]
circonscrire	to contain	[sound:circonscrire.mp3]
circonvenir	to circumvent<br>to get around	[sound:circonvenir.mp3]
clore	to close, end 	[sound:clore.mp3]
coller	to stick, paste, put	[sound:coller.mp3]
combattre	to combat, fight	[sound:combattre.mp3]
commander	to command, order	[sound:commander.mp3]
commettre	to commit	[sound:commettre.mp3]
comparaître	to appear in court 	[sound:compara%C3%AEtre.mp3]
comparer	to compare	[sound:comparer.mp3]
élire	to elect, choose	[sound:%C3%A9lire.mp3]
s'éloigner	to move away, go away, withdraw, step back, keep back, keep away	[sound:s%27%C3%A9loigner.mp3]
embrasser	to kiss, embrace	[sound:embrasser.mp3]
emmener	to lead, lead away, take away (persons)	[sound:emmener.mp3]
empêcher	to hinder, prevent	[sound:emp%C3%AAcher.mp3]
employer	to employ, use	[sound:employer.mp3]
emprunter	to borrow (from)	[sound:emprunter.mp3]
encourager	to encourage	[sound:encourager.mp3]
endormir	to fall asleep	[sound:endormir.mp3]
enfreindre	to infringe	[sound:enfreindre.mp3]
s'enfuir	to run away, slip away, escape, flee, fly away	[sound:s%27enfuir.mp3]
engager	to commit, bind	[sound:engager.mp3]
enjoindre	to enjoin, forbid, prohibit, command	[sound:enjoindre.mp3]
ennuyer	to bore, annoy, weary<br><br>s'ennuyer = to be bored	[sound:ennuyer.mp3]
énoncer	to express, state	[sound:%C3%A9noncer.mp3]
s'enquérir	to inquire	[sound:s%27enqu%C3%A9rir.mp3]
enregistrer	to record, register, enter, show	[sound:enregistrer.mp3]
enterrer	to bury	[sound:enterrer.mp3]
entraîner	to train, bring about, lead	[sound:entra%C3%AEner.mp3]
entreprendre	to undertake, engage upon	[sound:entreprendre.mp3]
entretenir	to look after	[sound:entretenir.mp3]
entrouvrir	to half-open	[sound:entrouvrir.mp3]
s'envoler	to take flight, take off	[sound:s%27envoler.mp3]
épeler	to spell	[sound:%C3%A9peler.mp3]
épouser	to marry	[sound:%C3%A9pouser.mp3]
éprouver	to try, test, put to the test, feel, experience	[sound:%C3%A9prouver.mp3]
équivaloir	to be equivalent to	[sound:%C3%A9quivaloir.mp3]
essuyer	to wipe, dust, wipe up	[sound:essuyer.mp3]
estimer	to estimate	[sound:estimer.mp3]
établir	to establish, set up, draw up	[sound:%C3%A9tablir.mp3]
éteindre	to extinguish, shut down (computer), turn off	[sound:%C3%A9teindre.mp3]
étonner	to amaze, astonish, stun, surprise	[sound:%C3%A9tonner.mp3]
étourdir	to stun, daze, make dizzy, deafen, bewilder	[sound:%C3%A9tourdir.mp3]
étreindre	to embrace, grip	[sound:%C3%A9treindre.mp3]
évaluer	to evaluate, appraise, assess, estimate	[sound:%C3%A9valuer.mp3]
éviter	to avoid	[sound:%C3%A9viter.mp3]
exagérer	to exaggerate	[sound:exag%C3%A9rer.mp3]
exclure	to expel, suspend, exclude, dismiss	[sound:exclure.mp3]
excuser	to excuse	[sound:excuser.mp3]
exiger	to demand, require	[sound:exiger.mp3]
exister	to exist	[sound:exister.mp3]
expliquer	to explain	[sound:expliquer.mp3]
explorer	to explore	[sound:explorer.mp3]
exprimer	to express	[sound:exprimer.mp3]
faiblir	to get weaker, fail, get fainter, die down, drop, diminish	[sound:faiblir.mp3]
faillir	to fail<br>to almost (do something)	[sound:faillir.mp3]
falloir	to be necessary<br><br>*MANY various uses, common with expressions	[sound:falloir.mp3]
feindre	to feign, make believe, pretend, simulate	[sound:feindre.mp3]
féliciter	to congratulate	[sound:f%C3%A9liciter.mp3]
fendre	to split, crack, cleave	[sound:fendre.mp3]
feuilleter	to leaf through	[sound:feuilleter.mp3]
fixer 	to fix, set	[sound:fixer+.mp3]
fonder	to found, establish, lay the foundation, 	[sound:fonder.mp3]
fondre	to melt, dissolve, mix colors	[sound:fondre.mp3]
fouiller	to dig deeply, excavate, search	[sound:fouiller.mp3]
fournir	to furnish, supply	[sound:fournir.mp3]
frapper	to knock, hit, strike, rap 	[sound:frapper.mp3]
frémir	to shudder, quiver, tremble	[sound:fr%C3%A9mir.mp3]
frire 	to deep-fry	[sound:frire+.mp3]
gaspiller	to waste	[sound:gaspiller.mp3]
gâter	to spoil, damage	[sound:g%C3%A2ter.mp3]
geindre	to moan 	[sound:geindre.mp3]
geler	to freeze	[sound:geler.mp3]
gêner	to bother, hamper, constrict, embarass, hinder, impede, inconvenience	[sound:g%C3%AAner.mp3]
gérer	to manage	[sound:g%C3%A9rer.mp3]
grandir	to grow (up, taller), increase	[sound:grandir.mp3]
gratter	to grate, scrape, scratch	[sound:gratter.mp3]
grêler	to hail (ice from the sky)	[sound:gr%C3%AAler.mp3]
grimper	to climb	[sound:grimper.mp3]
gronder	to chide, reprimand, scold	[sound:gronder.mp3]
guérir	to cure, heal, remedy, recover	[sound:gu%C3%A9rir.mp3]
s'habiller	to get dressed, to dress (onself)	[sound:s%27habiller.mp3]
habiter	to live (in), dwell (in), inhabit	[sound:habiter.mp3]
hésiter	to hesitate	[sound:h%C3%A9siter.mp3]
hoqueter	to hiccup, gasp	[sound:hoqueter.mp3]
ignorer	to be unaware of, to be unaware of, to ignore	[sound:ignorer.mp3]
imposer	to impose	[sound:imposer.mp3]
indiquer	to incidate, point out, show	[sound:indiquer.mp3]
induire	to mislead	[sound:induire.mp3]
s'informer	to find out, inquire, inform oneself	[sound:s%27informer.mp3]
compter	to count, intend, expect to	[sound:compter.mp3]
concevoir	to conceive	[sound:concevoir.mp3]
conclure	to conclude	[sound:conclure.mp3]
concourir	to compete (concurrently)	[sound:concourir.mp3]
conduire	to lead, drive, conduct, manage	[sound:conduire.mp3]
conserver	to preserve, conserve	[sound:conserver.mp3]
confondre	to confuse, confound	[sound:confondre.mp3]
conjoindre	to conjoin, unite	[sound:conjoindre.mp3]
conquérir	to conquer	[sound:conqu%C3%A9rir.mp3]
conseiller	to advise, counsel, recommend	[sound:conseiller.mp3]
consentir	to consent, agree	[sound:consentir.mp3]
considérer	to consider	[sound:consid%C3%A9rer.mp3]
consommer	to consume (drink, eat), consummate	[sound:consommer.mp3]
construire	to construct, build	[sound:construire.mp3]
contenir	to contain<br />to fit	[sound:contenir.mp3]
conter	to relate, narrate, recount	[sound:conter.mp3]
contraindre	to constrain, restrain, compel	[sound:contraindre.mp3]
contredire	to contradict	[sound:contredire.mp3]
contrevenir	to contravene	[sound:contrevenir.mp3]
convaincre	to convince	[sound:convaincre.mp3]
convenir	to suit, be appropriate<br>to agree, acknowledge	[sound:convenir.mp3]
correspondre	to correspond (as in write, and to fit, relate)	[sound:correspondre.mp3]
corrompre	to corrupt	[sound:corrompre.mp3]
coudre	to sew, stitch	[sound:coudre.mp3]
couvrir	to cover	[sound:couvrir.mp3]
craindre	to fear	[sound:craindre.mp3]
créer	to create	[sound:cr%C3%A9er.mp3]
crier	to shout, cry out	[sound:crier.mp3]
cueillir	to gather, pick	[sound:cueillir.mp3]
culpabiliser	to make one feel guilty	[sound:culpabiliser.mp3]
danser	to dance	[sound:danser.mp3]
débattre	to debate, discuss	[sound:d%C3%A9battre.mp3]
décevoir	to deceive, disappoint	[sound:d%C3%A9cevoir.mp3]
déchirer	to rip	[sound:d%C3%A9chirer.mp3]
décorer	to decorate	[sound:d%C3%A9corer.mp3]
découdre	to take the stitches out of<br>to take off/out, to come off	[sound:d%C3%A9coudre.mp3]
décourager	to discourage	[sound:d%C3%A9courager.mp3]
découvrir	to discover, uncover	[sound:d%C3%A9couvrir.mp3]
se dédire	to retract	[sound:se+d%C3%A9dire.mp3]
déduire	to deduce, infer, deduct	[sound:d%C3%A9duire.mp3]
défaillir	to faint, falter	[sound:d%C3%A9faillir.mp3]
défaire	to undo, untie	[sound:d%C3%A9faire.mp3]
défendre	to defend, forbid, prohibit	[sound:d%C3%A9fendre.mp3]
défricher	to clear, open up, prepare the ground	[sound:d%C3%A9fricher.mp3]
dégager	to free, clear (out), remove<br>to give off, emit	[sound:d%C3%A9gager.mp3]
déjeuner	to have lunch or breakfast	[sound:d%C3%A9jeuner.mp3]
déménager	to move (furniture, etc.)	[sound:d%C3%A9m%C3%A9nager.mp3]
demeurer	to reside, live, remain, stay	[sound:demeurer.mp3]
démolir	to demolish	[sound:d%C3%A9molir.mp3]
dénoncer	to denounce, terminate	[sound:d%C3%A9noncer.mp3]
dépasser	to pass, go beyond, exceed	[sound:d%C3%A9passer.mp3]
dépeindre	to depict, describe, portray	[sound:d%C3%A9peindre.mp3]
dépendre	to depend (on)<br>to be dependent (on)<br>to take down (something that is hanging)	[sound:d%C3%A9pendre.mp3]
dépenser	to spend (money)	[sound:d%C3%A9penser.mp3]
déplaire	to displease	[sound:d%C3%A9plaire.mp3]
déranger	to disturb, derange	[sound:d%C3%A9ranger.mp3]
désirer	to desire<br />	[sound:d%C3%A9sirer.mp3]
désobéir	to disobey	[sound:d%C3%A9sob%C3%A9ir.mp3]
dessiner	to draw, sketch	[sound:dessiner.mp3]
déteindre	to take the color out of <br>to fade, rub off	[sound:d%C3%A9teindre.mp3]
détenir	to hold, detain<br>to be in power	[sound:d%C3%A9tenir.mp3]
détourner	to turn aside, turn away, divert	[sound:d%C3%A9tourner.mp3]
détruire	to destroy	[sound:d%C3%A9truire.mp3]
développer	to develop, spread out	[sound:d%C3%A9velopper.mp3]
dévêtir	to undress	[sound:d%C3%A9v%C3%AAtir.mp3]
deviner	to guess	[sound:deviner.mp3]
diminuer	to diminish, decrease, lesson	[sound:diminuer.mp3]
dîner	to dine (have dinner)	[sound:d%C3%AEner.mp3]
diriger	to run, manage, lead, conduct, steer, pilot, direct, supervice	[sound:diriger.mp3]
discourir	to make a speech (discourse)	[sound:discourir.mp3]
discuter	to discuss, argue	[sound:discuter.mp3]
disparaître	to disappear	[sound:dispara%C3%AEtre.mp3]
dissoudre	to dissolve, disband	[sound:dissoudre.mp3]
divorcer	to get divorced	[sound:divorcer.mp3]
doubler	to double, repeat, dub	[sound:doubler.mp3]
échapper	to escape, avoid	[sound:%C3%A9chapper.mp3]
échouer	to fail, run aground	[sound:%C3%A9chouer.mp3]
éclore	to open, hatch	[sound:%C3%A9clore.mp3]
éconduire	to dismiss, reject, turn away	[sound:%C3%A9conduire.mp3]
écraser	to crush, squash, stub out, mash, grind, pound, flatten	[sound:%C3%A9craser.mp3]
effrayer	to frighten	[sound:effrayer.mp3]
égayer	to amuse, cheer up, enliven, entertain	[sound:%C3%A9gayer.mp3]
retirer	to draw (out) again, pull again, take something out/off	[sound:retirer.mp3]
inscrire	to note down, score	[sound:inscrire.mp3]
insister	to insist	[sound:insister.mp3]
instruire	to instruct	[sound:instruire.mp3]
interdire	to forbid, prohibit	[sound:interdire.mp3]
s'intéresser	to be interested in	[sound:s%27int%C3%A9resser.mp3]
interroger	to question, ask, interrogate	[sound:interroger.mp3]
interrompre	to interrupt	[sound:interrompre.mp3]
intervenir	to intervene, play a part, give a talk	[sound:intervenir.mp3]
introduire	to introduce, show in	[sound:introduire.mp3]
inventer	to invent, devise, make up	[sound:inventer.mp3]
jaillir	to spurt out, gush out, flow, ring out, spring out, shoot out	[sound:jaillir.mp3]
jaser	to chatter	[sound:jaser.mp3]
jaunir	to turn yellow	[sound:jaunir.mp3]
jeter	to throw, cast	[sound:jeter.mp3]
joindre	to join, contact	[sound:joindre.mp3]
jouir	to enjoy	[sound:jouir.mp3]
juger	to judge, deem	[sound:juger.mp3]
jurer	to swear, vow	[sound:jurer.mp3]
kidnapper	to kidnap	[sound:kidnapper.mp3]
klaxonner	to honk	[sound:klaxonner.mp3]
lâcher	to loosen, unleash, let go	[sound:l%C3%A2cher.mp3]
laisser	to let, allow, leave (alone)	[sound:laisser.mp3]
lancer	to hurl, launch, throw	[sound:lancer.mp3]
loger	to live, lodge	[sound:loger.mp3]
louer	to praise, rent, rent out	[sound:louer.mp3]
luire	to shine, glisten, glimmer, twinkle	[sound:luire.mp3]
maigrir	to lose weight, grow thin	[sound:maigrir.mp3]
maintenir	to maintain, support	[sound:maintenir.mp3]
manquer	to miss, lack	[sound:manquer.mp3]
marcher	to walk, march, run (machine), function	[sound:marcher.mp3]
maudire	to curse	[sound:maudire.mp3]
méconnaître	to misjudge, misunderstand, not to know, not to recognize	[sound:m%C3%A9conna%C3%AEtre.mp3]
médire	to malign, slander	[sound:m%C3%A9dire.mp3]
mélanger	to mix, blend, shuffle	[sound:m%C3%A9langer.mp3]
menacer	to threaten	[sound:menacer.mp3]
mener	to lead, control	[sound:mener.mp3]
mentir	to lie	[sound:mentir.mp3]
mépriser	to despise, scorn	[sound:m%C3%A9priser.mp3]
mériter	to deserve, to call for, merit	[sound:m%C3%A9riter.mp3]
mesurer	to measure	[sound:mesurer.mp3]
modérer	to moderate, restrain, reduce	[sound:mod%C3%A9rer.mp3]
montrer	to show, display, exhibit, point out	[sound:montrer.mp3]
moquer	to mock, make fun of	[sound:moquer.mp3]
mordre	to bite	[sound:mordre.mp3]
moudre	to mill, grind	[sound:moudre.mp3]
mouiller	to get something wet, dampen, baste, drop anchor	[sound:mouiller.mp3]
naviguer	to navigate, sail, browse, surf (internet)	[sound:naviguer.mp3]
négliger	to neglect, be careless about, pay no attention to	[sound:n%C3%A9gliger.mp3]
négocier	to negotiate	[sound:n%C3%A9gocier.mp3]
neutraliser	to neutralize, overpower	[sound:neutraliser.mp3]
nier	to deny	[sound:nier.mp3]
noircir	to blacken, dirty, darken	[sound:noircir.mp3]
nommer	to name, appoint	[sound:nommer.mp3]
nouer	to tie, knot	[sound:nouer.mp3]
nourrir	to feed, nourish	[sound:nourrir.mp3]
se noyer	to drown	[sound:se+noyer.mp3]
nuire	to harm, hinder	[sound:nuire.mp3]
obliger	to oblige	[sound:obliger.mp3]
omettre	to omit	[sound:omettre.mp3]
oser	to dare	[sound:oser.mp3]
paraître	to appear, seem	[sound:para%C3%AEtre.mp3]
parcourir	to cover, travel up and down, go all over	[sound:parcourir.mp3]
partager	to divide up, share	[sound:partager.mp3]
participer	to participate, take part in, be involved in	[sound:participer.mp3]
patiner	to skate	[sound:patiner.mp3]
pécher	to sin	[sound:p%C3%A9cher.mp3]
pêcher	to fish	[sound:p%C3%AAcher.mp3]
se peigner	to comb one's hair	[sound:se+peigner.mp3]
peindre	to paint, portray	[sound:peindre.mp3]
peler	to peel	[sound:peler.mp3]
pendre	to hang, suspend	[sound:pendre.mp3]
pénétrer	to enter, penetrate	[sound:p%C3%A9n%C3%A9trer.mp3]
percevoir	to perceive, detect, feel	[sound:percevoir.mp3]
périr	to perish, die	[sound:p%C3%A9rir.mp3]
permettre	to permit, allow, let	[sound:permettre.mp3]
persuader	to persuade, convince, induce	[sound:persuader.mp3]
peser	to weigh	[sound:peser.mp3]
pianoter	to tap (like a piano), drum one's fingers	[sound:pianoter.mp3]
plaindre	to pity	[sound:plaindre.mp3]
plaire	to please	[sound:plaire.mp3]
plaisanter	to joke (2)	[sound:plaisanter.mp3]
planter	to plant, stick, dump	[sound:planter.mp3]
plier	to fold, bend	[sound:plier.mp3]
plonger	to dive, swoop, plummet	[sound:plonger.mp3]
pondre	to lay (an egg)	[sound:pondre.mp3]
poser	to lay, place, put, set, pose	[sound:poser.mp3]
posséder	to possess, own, master	[sound:poss%C3%A9der.mp3]
poursuivre	to pursue, prosecute	[sound:poursuivre.mp3]
pousser	to push, grow	[sound:pousser.mp3]
prédire	to predict, foretell	[sound:pr%C3%A9dire.mp3]
préparer	to prepare	[sound:pr%C3%A9parer.mp3]
prescrire	to prescribe, recommend	[sound:prescrire.mp3]
présenter	to present, introduce	[sound:pr%C3%A9senter.mp3]
pressentir	to sense, have a premonition	[sound:pressentir.mp3]
presser	to press, squeeze	[sound:presser.mp3]
prétendre	to pretend, claim, maintain	[sound:pr%C3%A9tendre.mp3]
prêter	to lend	[sound:pr%C3%AAter.mp3]
se prévaloir	to pride onself on	[sound:se+pr%C3%A9valoir.mp3]
prévenir	to warn, forestall, ward off, prevent	[sound:pr%C3%A9venir.mp3]
prévoir	to foresee	[sound:pr%C3%A9voir.mp3]
prier	to pray, supplicate, entreat beg, request	[sound:prier.mp3]
produire	to produce	[sound:produire.mp3]
projeter	to project, plan, throw up, cast	[sound:projeter.mp3]
prononcer	to pronounce, declare	[sound:prononcer.mp3]
proscrire	to prohibit, ban, proscribe, banish	[sound:proscrire.mp3]
protéger	to protect	[sound:prot%C3%A9ger.mp3]
prouver	to prove	[sound:prouver.mp3]
puer	to stink	[sound:puer.mp3]
punir	to punish	[sound:punir.mp3]
ralentir	to slow down	[sound:ralentir.mp3]
ranger	to set (put) in order, tidy up	[sound:ranger.mp3]
rappeler	to recall, remind, call again, call back	[sound:rappeler.mp3]
rassurer	to reassure	[sound:rassurer.mp3]
rater	to fail, miss<br />	[sound:rater.mp3]
ravir	to delight, rob (somebody of something)	[sound:ravir.mp3]
reconduire	to escort, renew	[sound:reconduire.mp3]
reconstruire	to rebuild, reconstruct	[sound:reconstruire.mp3]
recoudre	to sew back on, stitch up	[sound:recoudre.mp3]
recourir	to race again, resort to, to turn to	[sound:recourir.mp3]
recouvrir	to cover, become covered	[sound:recouvrir.mp3]
récrire	to rewrite, write again	[sound:r%C3%A9crire.mp3]
recueillir	to collect, gather, harvest	[sound:recueillir.mp3]
rédiger	to write, compile, write up, draw up	[sound:r%C3%A9diger.mp3]
redire	to repeat, say again	[sound:redire.mp3]
réduire	to reduce, decrease, diminish	[sound:r%C3%A9duire.mp3]
réélire	to re-elect	[sound:r%C3%A9%C3%A9lire.mp3]
rejeter	to reject, throw back, deny	[sound:rejeter.mp3]
rejoindre	to rejoin, to agree with	[sound:rejoindre.mp3]
relire	to reread	[sound:relire.mp3]
remarquer	to remark, notice, observe, distinguish	[sound:remarquer.mp3]
remettre	to put (on) again, replace, put back, give back, postpone	[sound:remettre.mp3]
rencontrer	to meet, encounter	[sound:rencontrer.mp3]
rendre	to give back, return, render, vomit	[sound:rendre.mp3]
renoncer	to renounce	[sound:renoncer.mp3]
renouveler	to renew, re-elect, repeat	[sound:renouveler.mp3]
renvoyer	to dismiss, expel, suspend, send away	[sound:renvoyer.mp3]
répandre	to spread, scatter, spill	[sound:r%C3%A9pandre.mp3]
reparaître	to reappear	[sound:repara%C3%AEtre.mp3]
réparer	to repair	[sound:r%C3%A9parer.mp3]
repasser	to iron, pass again	[sound:repasser.mp3]
repeindre	to repaint	[sound:repeindre.mp3]
se repentir	to repent	[sound:se+repentir.mp3]
repérer	to spot, locate	[sound:rep%C3%A9rer.mp3]
reprendre	to take back, recover, resume	[sound:reprendre.mp3]
réprimander	to reprimand	[sound:r%C3%A9primander.mp3]
reproduire	to reproduce	[sound:reproduire.mp3]
résoudre	to resolve, solve	[sound:r%C3%A9soudre.mp3]
ressembler	to resemble	[sound:ressembler.mp3]
ressentir	to feel	[sound:ressentir.mp3]
restreindre	to restrict	[sound:restreindre.mp3]
retenir	to retain, keep, detain, hold back	[sound:retenir.mp3]
revendiquer	to demand, claim responsibility for, claim	[sound:revendiquer.mp3]
rêver	to dream (during sleep)	[sound:r%C3%AAver.mp3]
revêtir	to put on (uniform)<br>to take on (appearance, character)	[sound:rev%C3%AAtir.mp3]
revoir	to see again	[sound:revoir.mp3]
riposter	to retaliate, answer back, counter attack	[sound:riposter.mp3]
rire	to laugh	[sound:rire.mp3]
rompre	to break, burst, shatter, break off	[sound:rompre.mp3]
rougir	to redden, blush	[sound:rougir.mp3]
rouler	to roll, drive (a car), ride along	[sound:rouler.mp3]
rouvrir	to reopen	[sound:rouvrir.mp3]
saisir	to seize, grasp, comprehend	[sound:saisir.mp3]
salir	to soil, dirty	[sound:salir.mp3]
satisfaire	to satisfy	[sound:satisfaire.mp3]
sauter	to jump, leap	[sound:sauter.mp3]
sauver	to save, rescue	[sound:sauver.mp3]
secouer	to shake, shake off	[sound:secouer.mp3]
secourir	to help, relieve	[sound:secourir.mp3]
séduire	to charm, appeal to	[sound:s%C3%A9duire.mp3]
séjourner	to sojourn, live somewhere temporarily	[sound:s%C3%A9journer.mp3]
sembler	to seem	[sound:sembler.mp3]
séparer	to separate	[sound:s%C3%A9parer.mp3]
serrer	to grasp, press, squeeze, shake (hands)	[sound:serrer.mp3]
servir	to serve, be useful	[sound:servir.mp3]
siffler	to whistle, hiss, boo	[sound:siffler.mp3]
signaler	to signal, point out	[sound:signaler.mp3]
signer	to sign	[sound:signer.mp3]
signifier	to mean	[sound:signifier.mp3]
skier	to ski	[sound:skier.mp3]
songer	to dream, think	[sound:songer.mp3]
sonner	to ring	[sound:sonner.mp3]
souffler	to blow, pant	[sound:souffler.mp3]
souffrir	to suffer, endure	[sound:souffrir.mp3]
souiller	to soil, dirty, muddy, sully (reputation)	[sound:souiller.mp3]
soumettre	to submit	[sound:soumettre.mp3]
sourire	to smile	[sound:sourire.mp3]
souscrire	to subscribe (book, new publication, fund)	[sound:souscrire.mp3]
soutenir	to support	[sound:soutenir.mp3]
se souvenir	to remember	[sound:se+souvenir.mp3]
subir	to suffer, undergo	[sound:subir.mp3]
subvenir	to provide for, support	[sound:subvenir.mp3]
sucer	to suck	[sound:sucer.mp3]
succomber	to succumb, die	[sound:succomber.mp3]
suffire	to suffice, be enough	[sound:suffire.mp3]
suggérer	to suggest	[sound:sugg%C3%A9rer.mp3]
supplier	to beg, implore, supplicate	[sound:supplier.mp3]
supposer	to suppose	[sound:supposer.mp3]
supporter	to support, endure, hold up, prop up, tolerate	[sound:supporter.mp3]
surprendre	to surprise	[sound:surprendre.mp3]
survenir	to occur, arise, take place	[sound:survenir.mp3]
survivre	to survive	[sound:survivre.mp3]
survoler	to fly over	[sound:survoler.mp3]
tapoter	to tap, pat	[sound:tapoter.mp3]
teindre	to dye	[sound:teindre.mp3]
téléphoner	to call (on the telephone)	[sound:t%C3%A9l%C3%A9phoner.mp3]
tendre	to strain, stretch, tighten, tend	[sound:tendre.mp3]
tenter	to tempt, attempt, try	[sound:tenter.mp3]
tirer	to draw out, shoot, pull	[sound:tirer.mp3]
tondre	to shear, mow	[sound:tondre.mp3]
tonner	to thunder, boom	[sound:tonner.mp3]
tordre	to twist	[sound:tordre.mp3]
toucher	to touch, affect	[sound:toucher.mp3]
tourner	to turn	[sound:tourner.mp3]
tousser	to cough	[sound:tousser.mp3]
tracer	to draw (something out: water, card, etc.)<br>to draw (plan, line, circle)	[sound:tracer.mp3]
traduire	to translate	[sound:traduire.mp3]
trahir	to betray	[sound:trahir.mp3]
traiter	to treat (somebody a certain way), negotiate	[sound:traiter.mp3]
transmettre	to transmit, transfer	[sound:transmettre.mp3]
transparaître	to show through	[sound:transpara%C3%AEtre.mp3]
traverser	to traverse, cross	[sound:traverser.mp3]
tressaillir	to quiver, shudder, wince	[sound:tressaillir.mp3]
tricher	to trick, cheat	[sound:tricher.mp3]
tuer	to kill	[sound:tuer.mp3]
tutoyer	to use &quot;tu&quot; with somebody when speaking	[sound:tutoyer.mp3]
unir	to unite, join	[sound:unir.mp3]
user	to wear out, wear down	[sound:user.mp3]
vaincre	to vanquish, conquer	[sound:vaincre.mp3]
valoir	to be worth, be as good as, deserve, merit	[sound:valoir.mp3]
vanter	to vaunt, praise	[sound:vanter.mp3]
varier	to vary	[sound:varier.mp3]
veiller	to stay up (late), be watchful	[sound:veiller.mp3]
venger	to avenge	[sound:venger.mp3]
verdir	to turn green	[sound:verdir.mp3]
vérifier	to verify, check, audit	[sound:v%C3%A9rifier.mp3]
verser	to pour	[sound:verser.mp3]
vêtir	to clothe, dress	[sound:v%C3%AAtir.mp3]
vieillir	to grow old, age	[sound:vieillir.mp3]
viser	to aim	[sound:viser.mp3]
vivre	to live (be alive)	[sound:vivre.mp3]
voiler	to veil	[sound:voiler.mp3]
voler	to fly, steal	[sound:voler.mp3]
voter	to vote	[sound:voter.mp3]
vouvoyer	to use &quot;vous&quot; when speaking with somebody	[sound:vouvoyer.mp3]
voyager	to travel	[sound:voyager.mp3]
zébrer	to stripe	[sound:z%C3%A9brer.mp3]
zézayer	to lisp	[sound:z%C3%A9zayer.mp3]
zoner	to zone	[sound:zoner.mp3]
frissonner	to quake (fear), shudder (horror), shiver (from cold)	[sound:frissonner.mp3]
rêvasser	to dream (when awake)	[sound:r%C3%AAvasser.mp3]
accroître	to increase, make greater, to enlarge	[sound:accro%C3%AEtre.mp3]
s'en aller	to go away	[sound:s%27en+aller.mp3]
s'amuser	to have a good time<br>to amuse oneself<br>to enjoy oneself	[sound:s%27amuser.mp3]
apprécier	to appreciate	[sound:appr%C3%A9cier.mp3]
s'arrêter	to stop oneself, to pause	[sound:s%27arr%C3%AAter.mp3]
assiéger	to besiege<br />to lay seige to	[sound:assi%C3%A9ger.mp3]
baver	to drool	[sound:baver.mp3]
brancher	to plug in, connect	[sound:brancher.mp3]
croître	to grow, increase	[sound:cro%C3%AEtre.mp3]
se débrouiller	to manage, improvise, get by	[sound:se+d%C3%A9brouiller.mp3]
décroître	to decrease, diminish	[sound:d%C3%A9cro%C3%AEtre.mp3]
se dépêcher	to hurry, hasten	[sound:se+d%C3%A9p%C3%AAcher.mp3]
émouvoir	to move, touch, excite, arouse	[sound:%C3%A9mouvoir.mp3]
enduire	to coat (cover a surface)	[sound:enduire.mp3]
s'étendre	to stretch oneself, to stretch out, lie down	[sound:s%27%C3%A9tendre.mp3]
s'évanouir	to faint, lose consciousness, swoon, vanish	[sound:s%27%C3%A9vanouir.mp3]
s'exclure mutuellement	to be mutually exclusive	[sound:s%27exclure+mutuellement.mp3]
s'excuser	to excuse oneself, apologize	[sound:s%27excuser.mp3]
se fâcher	to become angry	[sound:se+f%C3%A2cher.mp3]
se fier	to depend on, rely on, trust in	[sound:se+fier.mp3]
fuir	to flee, fly off, shun<br />to leak (gas, oil, etc.)	[sound:fuir.mp3]
se laver	to wash oneself	[sound:se+laver.mp3]
se lever	to get up	[sound:se+lever.mp3]
se méfier	to beware, distrust, mistrust	[sound:se+m%C3%A9fier.mp3]
se méprendre	to be mistaken, to mistake	[sound:se+m%C3%A9prendre.mp3]
se mettre	to begin, start, place oneself	[sound:se+mettre.mp3]
mirer	to mirror	[sound:mirer.mp3]
modeler	to model, shape	[sound:modeler.mp3]
mouvoir	to move	[sound:mouvoir.mp3]
s'occuper	to be busy, keep oneself busy	[sound:s%27occuper.mp3]
se plaindre	to complain, lament, moan	[sound:se+plaindre.mp3]
se presser	to be in a hurry, make haste, rush, crowd	[sound:se+presser.mp3]
programmer	to program, plan	[sound:programmer.mp3]
se rappeler	to remember, recall, recollect	[sound:se+rappeler.mp3]
se reposer	to rest 	[sound:se+reposer.mp3]
se retirer	to retire, withdraw	[sound:se+retirer.mp3]
se sauver	to run away, to rush off, to escape	[sound:se+sauver.mp3]
sécher	to dry	[sound:s%C3%A9cher.mp3]
se servir	to serve oneself, help oneself (to food and drink)	[sound:se+servir.mp3]
se taire	to be silent, quiet	[sound:se+taire.mp3]
traire	to milk	[sound:traire.mp3]
travailler	to work	[sound:travailler.mp3]
se tromper	to be mistaken, to be wrong (about something)	[sound:se+tromper.mp3]
tromper	to cheat, deceive	[sound:tromper.mp3]
trouver	to find	[sound:trouver.mp3]
se trouver	to be located, be situated	[sound:se+trouver.mp3]
vendre	to sell	[sound:vendre.mp3]
voir	to see	[sound:voir.mp3]
déverrouiller	to unlock, release, unboldt	[sound:d%C3%A9verrouiller.mp3]
détendre	to relax	
coopérer	to cooperate	
précéder	to precede	
régner	to reign	
rouspéter	to grumble, grouch	
tolérer	to tolerate	
ensorceler	to bewitch	
aboyer	to bark	
rayer	to cross out	
revendre	to sell, sell off	
grossir	to gain weight	
